barcode	dropkick_label_03
AAACCTGAGAAAGTGG-1	GoodQuality
AAACCTGCAAACCCAT-1	GoodQuality
AAACCTGCACGGTAGA-1	LowQuality
AAACCTGCAGTGGAGT-1	GoodQuality
AAACCTGCATACCATG-1	GoodQuality
AAACCTGGTAGCGCTC-1	GoodQuality
AAACCTGGTGAAATCA-1	GoodQuality
AAACCTGGTTCCAACA-1	GoodQuality
AAACCTGTCGGCGCTA-1	GoodQuality
AAACGGGAGCACCGTC-1	GoodQuality
AAACGGGAGCTAGTCT-1	GoodQuality
AAACGGGAGCTGTTCA-1	GoodQuality
AAACGGGAGGGCTTCC-1	GoodQuality
AAACGGGCAACGCACC-1	GoodQuality
AAACGGGCAAGGGTCA-1	GoodQuality
AAACGGGCAGACTCGC-1	GoodQuality
AAACGGGCATGTCGAT-1	GoodQuality
AAACGGGGTAAGCACG-1	GoodQuality
AAACGGGGTACGAAAT-1	GoodQuality
AAACGGGGTATAGGGC-1	GoodQuality
AAACGGGGTCCAAGTT-1	GoodQuality
AAACGGGTCTAACGGT-1	GoodQuality
AAAGATGAGACGCAAC-1	GoodQuality
AAAGATGAGCACGCCT-1	GoodQuality
AAAGATGAGCCACGTC-1	LowQuality
AAAGATGAGCTCCCAG-1	LowQuality
AAAGATGCAAGCTGTT-1	GoodQuality
AAAGATGGTACACCGC-1	GoodQuality
AAAGATGGTAGCCTAT-1	GoodQuality
AAAGATGTCAAGCCTA-1	GoodQuality
AAAGATGTCGCCCTTA-1	LowQuality
AAAGATGTCGTGGGAA-1	LowQuality
AAAGCAAAGAGTACAT-1	LowQuality
AAAGCAAAGATATACG-1	GoodQuality
AAAGCAAAGCTACCGC-1	GoodQuality
AAAGCAAAGCTGCAAG-1	GoodQuality
AAAGCAAAGGCTATCT-1	LowQuality
AAAGCAAAGGTACTCT-1	LowQuality
AAAGCAAAGTTAAGTG-1	GoodQuality
AAAGCAACAAACAACA-1	GoodQuality
AAAGCAACAAATCCGT-1	GoodQuality
AAAGCAACAGATGGGT-1	GoodQuality
AAAGCAACAGTAAGAT-1	LowQuality
AAAGCAATCAACGCTA-1	LowQuality
AAAGCAATCACGAAGG-1	LowQuality
AAAGCAATCAGCTTAG-1	GoodQuality
AAAGCAATCGAACTGT-1	GoodQuality
AAAGCAATCGTTGACA-1	GoodQuality
AAAGTAGAGCTAGTGG-1	LowQuality
AAAGTAGAGGGAACGG-1	LowQuality
AAAGTAGCACCCATTC-1	GoodQuality
AAAGTAGCACGGATAG-1	LowQuality
AAAGTAGCAGCCTTTC-1	GoodQuality
AAAGTAGCATTCACTT-1	LowQuality
AAAGTAGGTCACTGGC-1	GoodQuality
AAAGTAGGTGCACCAC-1	GoodQuality
AAAGTAGGTTCGCGAC-1	GoodQuality
AAAGTAGGTTTCGCTC-1	LowQuality
AAAGTAGTCAGCTTAG-1	GoodQuality
AAAGTAGTCCGTAGGC-1	GoodQuality
AAAGTAGTCGCGTTTC-1	GoodQuality
AAAGTAGTCGTCACGG-1	GoodQuality
AAAGTAGTCTTACCTA-1	LowQuality
AAAGTAGTCTTCCTTC-1	GoodQuality
AAATGCCAGATTACCC-1	LowQuality
AAATGCCAGGAGTAGA-1	GoodQuality
AAATGCCCAAGTCTGT-1	LowQuality
AAATGCCCAATTCCTT-1	LowQuality
AAATGCCCACTGTGTA-1	GoodQuality
AAATGCCCATACCATG-1	LowQuality
AAATGCCGTTAGATGA-1	LowQuality
AAATGCCTCCGTACAA-1	GoodQuality
AAATGCCTCTTGAGGT-1	GoodQuality
AACACGTAGAGGTAGA-1	GoodQuality
AACACGTCAAGTTGTC-1	LowQuality
AACACGTCACATGACT-1	GoodQuality
AACACGTCATGGTCAT-1	LowQuality
AACACGTGTCCTCTTG-1	GoodQuality
AACACGTGTGAAATCA-1	GoodQuality
AACACGTTCCGTAGGC-1	GoodQuality
AACACGTTCTCGAGTA-1	GoodQuality
AACCATGAGAGGGCTT-1	GoodQuality
AACCATGAGCCGCCTA-1	LowQuality
AACCATGCAAAGTCAA-1	GoodQuality
AACCATGCAATAAGCA-1	LowQuality
AACCATGCACGAAAGC-1	GoodQuality
AACCATGCACTTCGAA-1	LowQuality
AACCATGGTCCGAAGA-1	GoodQuality
AACCATGGTGGGTCAA-1	LowQuality
AACCATGTCCAGTAGT-1	LowQuality
AACCATGTCGGAAATA-1	LowQuality
AACCGCGAGACCACGA-1	GoodQuality
AACCGCGAGATGCCTT-1	LowQuality
AACCGCGCAGGATCGA-1	GoodQuality
AACCGCGCATGCAATC-1	GoodQuality
AACCGCGGTACGAAAT-1	LowQuality
AACCGCGGTAGCACGA-1	LowQuality
AACCGCGGTCACAAGG-1	GoodQuality
AACCGCGGTGACAAAT-1	LowQuality
AACCGCGGTGAGCGAT-1	LowQuality
AACCGCGTCACAACGT-1	GoodQuality
AACCGCGTCATTCACT-1	GoodQuality
AACCGCGTCCGTCATC-1	LowQuality
AACGTTGAGAAGAAGC-1	GoodQuality
AACGTTGAGAAGGCCT-1	LowQuality
AACGTTGAGAGTCTGG-1	GoodQuality
AACGTTGCAACAACCT-1	LowQuality
AACGTTGCAGTTTACG-1	GoodQuality
AACGTTGTCTTCCTTC-1	GoodQuality
AACTCAGAGTTTCCTT-1	LowQuality
AACTCAGCACCTCGTT-1	GoodQuality
AACTCAGCACGGTAGA-1	GoodQuality
AACTCAGCAGGACCCT-1	GoodQuality
AACTCAGCATCAGTAC-1	GoodQuality
AACTCAGCATGGAATA-1	GoodQuality
AACTCAGGTCACTTCC-1	GoodQuality
AACTCAGGTCGCGTGT-1	GoodQuality
AACTCAGGTGACGGTA-1	LowQuality
AACTCAGTCAGATAAG-1	LowQuality
AACTCAGTCTCATTCA-1	GoodQuality
AACTCCCAGCCACGTC-1	LowQuality
AACTCCCAGGCGCTCT-1	GoodQuality
AACTCCCAGTATGACA-1	LowQuality
AACTCCCAGTCGAGTG-1	GoodQuality
AACTCCCAGTCGTACT-1	GoodQuality
AACTCCCAGTGTACGG-1	LowQuality
AACTCCCCAAGAGTCG-1	GoodQuality
AACTCCCCAATTGCTG-1	GoodQuality
AACTCCCCAGATCTGT-1	GoodQuality
AACTCCCCAGCTGTGC-1	GoodQuality
AACTCCCCATTCTTAC-1	LowQuality
AACTCCCGTGTGTGCC-1	GoodQuality
AACTCCCGTTCCACGG-1	LowQuality
AACTCCCTCGTCTGCT-1	LowQuality
AACTCCCTCGTGTAGT-1	GoodQuality
AACTCCCTCTCTTATG-1	GoodQuality
AACTCCCTCTGGTTCC-1	LowQuality
AACTCTTAGACAGACC-1	LowQuality
AACTCTTAGACCACGA-1	GoodQuality
AACTCTTAGCTGTCTA-1	GoodQuality
AACTCTTAGGATATAC-1	GoodQuality
AACTCTTAGGTGCAAC-1	GoodQuality
AACTCTTAGTTACGGG-1	GoodQuality
AACTCTTCAAGAGTCG-1	LowQuality
AACTCTTCACAACGCC-1	LowQuality
AACTCTTCACTATCTT-1	LowQuality
AACTCTTGTAGCGCTC-1	GoodQuality
AACTCTTGTCAACTGT-1	GoodQuality
AACTCTTGTTGACGTT-1	GoodQuality
AACTCTTGTTTGTGTG-1	GoodQuality
AACTCTTTCAACACAC-1	GoodQuality
AACTCTTTCAATACCG-1	GoodQuality
AACTCTTTCGTAGATC-1	GoodQuality
AACTGGTAGAAACGAG-1	GoodQuality
AACTGGTAGACAGAGA-1	GoodQuality
AACTGGTAGTCAAGCG-1	GoodQuality
AACTGGTAGTGGAGAA-1	GoodQuality
AACTGGTCAAACGCGA-1	GoodQuality
AACTGGTCAGACACTT-1	GoodQuality
AACTGGTCAGATAATG-1	LowQuality
AACTGGTGTACCTACA-1	GoodQuality
AACTGGTGTCTCATCC-1	LowQuality
AACTGGTGTGTCTGAT-1	LowQuality
AACTGGTTCAAACAAG-1	GoodQuality
AACTGGTTCAGCACAT-1	GoodQuality
AACTGGTTCAGCTCGG-1	GoodQuality
AACTGGTTCTCCGGTT-1	GoodQuality
AACTTTCAGAAGAAGC-1	GoodQuality
AACTTTCAGAATGTTG-1	GoodQuality
AACTTTCAGACAGACC-1	GoodQuality
AACTTTCAGCCATCGC-1	GoodQuality
AACTTTCCAATAAGCA-1	GoodQuality
AACTTTCCACAGACAG-1	GoodQuality
AACTTTCCAGTACACT-1	LowQuality
AACTTTCCATCCAACA-1	LowQuality
AACTTTCCATTCTTAC-1	GoodQuality
AACTTTCGTAATCGTC-1	GoodQuality
AACTTTCGTCTTGATG-1	LowQuality
AACTTTCGTGGCGAAT-1	GoodQuality
AACTTTCGTGTGAAAT-1	GoodQuality
AACTTTCTCAAACAAG-1	GoodQuality
AACTTTCTCACCCTCA-1	GoodQuality
AACTTTCTCGAACTGT-1	GoodQuality
AACTTTCTCTTTACAC-1	GoodQuality
AAGACCTAGTCTCGGC-1	LowQuality
AAGACCTAGTTAGGTA-1	LowQuality
AAGACCTCACATTTCT-1	GoodQuality
AAGACCTCAGCCAGAA-1	GoodQuality
AAGACCTCATGTTCCC-1	GoodQuality
AAGACCTGTCCGTTAA-1	GoodQuality
AAGACCTGTTAAAGTG-1	GoodQuality
AAGACCTGTTAAGACA-1	LowQuality
AAGACCTTCCGCATCT-1	GoodQuality
AAGACCTTCCTGTACC-1	GoodQuality
AAGCCGCAGAGGACGG-1	GoodQuality
AAGCCGCAGAGGTTGC-1	LowQuality
AAGCCGCAGATATGGT-1	LowQuality
AAGCCGCAGGCATGGT-1	GoodQuality
AAGCCGCAGGCCATAG-1	GoodQuality
AAGCCGCCAAATACAG-1	GoodQuality
AAGCCGCCACTGTCGG-1	GoodQuality
AAGCCGCCAGGAATGC-1	GoodQuality
AAGCCGCCAGTGACAG-1	LowQuality
AAGCCGCCATTGGTAC-1	LowQuality
AAGCCGCGTCGCGGTT-1	GoodQuality
AAGCCGCGTTGATTCG-1	GoodQuality
AAGCCGCTCAGGCCCA-1	GoodQuality
AAGCCGCTCATCTGTT-1	GoodQuality
AAGCCGCTCCTCTAGC-1	GoodQuality
AAGGAGCCAAGCGTAG-1	GoodQuality
AAGGAGCCAAGTTCTG-1	GoodQuality
AAGGAGCCAATTCCTT-1	GoodQuality
AAGGAGCGTAAATACG-1	GoodQuality
AAGGAGCGTGCGATAG-1	GoodQuality
AAGGAGCGTGTCTGAT-1	GoodQuality
AAGGAGCGTGTGTGCC-1	LowQuality
AAGGAGCTCATCTGTT-1	GoodQuality
AAGGAGCTCTCATTCA-1	LowQuality
AAGGCAGAGATCACGG-1	LowQuality
AAGGCAGAGTCCTCCT-1	GoodQuality
AAGGCAGCAAATCCGT-1	GoodQuality
AAGGCAGCACCTGGTG-1	LowQuality
AAGGCAGCAGCCTATA-1	GoodQuality
AAGGCAGGTGCAACGA-1	LowQuality
AAGGCAGGTGGCCCTA-1	GoodQuality
AAGGCAGTCACGACTA-1	GoodQuality
AAGGCAGTCAGAAATG-1	GoodQuality
AAGGCAGTCCCATTAT-1	GoodQuality
AAGGTTCAGCGTCTAT-1	LowQuality
AAGGTTCAGTAGTGCG-1	LowQuality
AAGGTTCCACTACAGT-1	GoodQuality
AAGGTTCCATTTCACT-1	GoodQuality
AAGGTTCGTCAGAATA-1	GoodQuality
AAGGTTCGTCCGAATT-1	GoodQuality
AAGGTTCGTGTTTGGT-1	LowQuality
AAGGTTCTCAACGAAA-1	LowQuality
AAGGTTCTCCGGCACA-1	LowQuality
AAGTCTGAGCTGCAAG-1	GoodQuality
AAGTCTGAGTGGAGAA-1	LowQuality
AAGTCTGCACGAAAGC-1	LowQuality
AAGTCTGCACGGTAAG-1	LowQuality
AAGTCTGCACGTGAGA-1	LowQuality
AAGTCTGCATCCAACA-1	GoodQuality
AAGTCTGGTAAATACG-1	LowQuality
AAGTCTGGTCCGTGAC-1	GoodQuality
AAGTCTGGTCTGGAGA-1	GoodQuality
AAGTCTGGTTCAGCGC-1	LowQuality
AAGTCTGGTTCATGGT-1	GoodQuality
AAGTCTGGTTCGCTAA-1	GoodQuality
AAGTCTGGTTGAGTTC-1	GoodQuality
AAGTCTGTCAGCAACT-1	GoodQuality
AAGTCTGTCATGGTCA-1	LowQuality
AAGTCTGTCATTGCCC-1	GoodQuality
AAGTCTGTCTGTCTAT-1	GoodQuality
AATCCAGAGGATGGAA-1	GoodQuality
AATCCAGCAATAAGCA-1	GoodQuality
AATCCAGCACAACTGT-1	LowQuality
AATCCAGCAGACTCGC-1	GoodQuality
AATCCAGCATAGACTC-1	LowQuality
AATCCAGCATGCGCAC-1	LowQuality
AATCCAGGTCGGCTCA-1	GoodQuality
AATCCAGGTTAAGAAC-1	LowQuality
AATCGGTAGATAGGAG-1	GoodQuality
AATCGGTAGGCATTGG-1	LowQuality
AATCGGTAGTCTTGCA-1	GoodQuality
AATCGGTCAGCTATTG-1	GoodQuality
AATCGGTCAGTTTACG-1	LowQuality
AATCGGTGTAAAGTCA-1	GoodQuality
AATCGGTGTACCGTAT-1	LowQuality
AATCGGTGTCCAAGTT-1	GoodQuality
AATCGGTTCGCACTCT-1	LowQuality
AATCGGTTCGTACGGC-1	LowQuality
ACACCAAAGATATGCA-1	GoodQuality
ACACCAAAGCTATGCT-1	GoodQuality
ACACCAAAGTATCTCG-1	GoodQuality
ACACCAAAGTGGAGTC-1	GoodQuality
ACACCAAAGTTATCGC-1	GoodQuality
ACACCAACAACACGCC-1	LowQuality
ACACCAACAACGCACC-1	GoodQuality
ACACCAACAAGTTGTC-1	GoodQuality
ACACCAACACCAACCG-1	GoodQuality
ACACCAACACGGTGTC-1	GoodQuality
ACACCAACACGTCAGC-1	LowQuality
ACACCAACATGGTTGT-1	GoodQuality
ACACCAAGTAAATGAC-1	GoodQuality
ACACCAAGTAGAAGGA-1	GoodQuality
ACACCAATCCAAACAC-1	GoodQuality
ACACCAATCCAGATCA-1	GoodQuality
ACACCAATCCTATTCA-1	GoodQuality
ACACCAATCGAGAACG-1	GoodQuality
ACACCAATCTACCTGC-1	GoodQuality
ACACCAATCTATCCCG-1	LowQuality
ACACCAATCTCTTGAT-1	GoodQuality
ACACCCTAGCCACTAT-1	LowQuality
ACACCCTAGTGTACTC-1	GoodQuality
ACACCCTCAAACTGCT-1	LowQuality
ACACCCTCAAGGGTCA-1	LowQuality
ACACCCTCAATCCAAC-1	LowQuality
ACACCCTGTCGCGGTT-1	GoodQuality
ACACCCTTCATCACCC-1	GoodQuality
ACACCCTTCTTCATGT-1	GoodQuality
ACACCCTTCTTGTTTG-1	GoodQuality
ACACCGGAGGACGAAA-1	GoodQuality
ACACCGGAGGGATGGG-1	GoodQuality
ACACCGGCACTTGGAT-1	LowQuality
ACACCGGCAGGGTATG-1	LowQuality
ACACCGGCAGGTCCAC-1	GoodQuality
ACACCGGCAGTTAACC-1	GoodQuality
ACACCGGGTGAGTATA-1	GoodQuality
ACACCGGGTGCGCTTG-1	GoodQuality
ACACCGGTCACTTATC-1	LowQuality
ACACCGGTCATGTCCC-1	GoodQuality
ACACCGGTCGCATGGC-1	LowQuality
ACACCGGTCGGTTAAC-1	LowQuality
ACACTGAAGACATAAC-1	GoodQuality
ACACTGAAGCGTTCCG-1	GoodQuality
ACACTGAAGGACCACA-1	GoodQuality
ACACTGAAGGCCATAG-1	LowQuality
ACACTGAAGTGCGATG-1	GoodQuality
ACACTGAAGTGTCCCG-1	GoodQuality
ACACTGACAAGGACAC-1	LowQuality
ACACTGACAGGCTCAC-1	LowQuality
ACACTGACATACAGCT-1	LowQuality
ACACTGAGTAAATACG-1	GoodQuality
ACACTGAGTACCGTAT-1	GoodQuality
ACACTGAGTACCTACA-1	GoodQuality
ACACTGAGTCGTGGCT-1	GoodQuality
ACACTGAGTGAGGCTA-1	GoodQuality
ACACTGAGTTGGTTTG-1	GoodQuality
ACACTGATCCACGCAG-1	LowQuality
ACACTGATCTGTTGAG-1	GoodQuality
ACAGCCGAGAATCTCC-1	LowQuality
ACAGCCGAGCGATAGC-1	GoodQuality
ACAGCCGAGCGCCTCA-1	GoodQuality
ACAGCCGAGCTAGTGG-1	GoodQuality
ACAGCCGAGCTGCAAG-1	GoodQuality
ACAGCCGCAACCGCCA-1	GoodQuality
ACAGCCGCAAGGACTG-1	GoodQuality
ACAGCCGCAAGGTTCT-1	LowQuality
ACAGCCGCACATCCGG-1	GoodQuality
ACAGCCGCAGGCTCAC-1	GoodQuality
ACAGCCGCATGGATGG-1	LowQuality
ACAGCCGGTAGCGCAA-1	LowQuality
ACAGCCGGTCGATTGT-1	GoodQuality
ACAGCCGTCAAGGTAA-1	LowQuality
ACAGCCGTCACCTTAT-1	GoodQuality
ACAGCCGTCGGTGTTA-1	GoodQuality
ACAGCCGTCGGTTAAC-1	GoodQuality
ACAGCCGTCTTACCTA-1	GoodQuality
ACAGCTAAGATGTCGG-1	GoodQuality
ACAGCTAAGCGACGTA-1	GoodQuality
ACAGCTAAGCGCCTCA-1	LowQuality
ACAGCTAAGGAGTCTG-1	GoodQuality
ACAGCTAAGTGCCATT-1	GoodQuality
ACAGCTAAGTTATCGC-1	GoodQuality
ACAGCTACAAGGTGTG-1	LowQuality
ACAGCTACAAGTCATC-1	LowQuality
ACAGCTACAATTCCTT-1	GoodQuality
ACAGCTACACCTTGTC-1	GoodQuality
ACAGCTACAGTGACAG-1	LowQuality
ACAGCTAGTACGACCC-1	GoodQuality
ACAGCTAGTACTTGAC-1	GoodQuality
ACAGCTAGTATCTGCA-1	GoodQuality
ACAGCTAGTCCAACTA-1	GoodQuality
ACAGCTAGTCTAAAGA-1	GoodQuality
ACAGCTAGTCTAGCCG-1	GoodQuality
ACAGCTAGTGTGACGA-1	GoodQuality
ACAGCTAGTTATGTGC-1	LowQuality
ACAGCTATCAAACAAG-1	LowQuality
ACAGCTATCCACGACG-1	GoodQuality
ACAGCTATCCATGAAC-1	GoodQuality
ACATACGAGAACAATC-1	GoodQuality
ACATACGAGCCACCTG-1	LowQuality
ACATACGAGCTAACAA-1	LowQuality
ACATACGAGCTTCGCG-1	GoodQuality
ACATACGAGGCCCTCA-1	GoodQuality
ACATACGAGGGATGGG-1	LowQuality
ACATACGCAAAGGAAG-1	GoodQuality
ACATACGCACCCATGG-1	GoodQuality
ACATACGTCACCTTAT-1	GoodQuality
ACATACGTCAGCACAT-1	GoodQuality
ACATACGTCTGACCTC-1	GoodQuality
ACATCAGAGGAGTTGC-1	GoodQuality
ACATCAGAGGCTACGA-1	GoodQuality
ACATCAGAGTAGCCGA-1	GoodQuality
ACATCAGAGTCTCCTC-1	GoodQuality
ACATCAGAGTGGAGAA-1	GoodQuality
ACATCAGAGTTAGGTA-1	LowQuality
ACATCAGCATCGGACC-1	GoodQuality
ACATCAGGTCGTGGCT-1	GoodQuality
ACATCAGTCGTCTGCT-1	LowQuality
ACATCAGTCTAACTCT-1	GoodQuality
ACATCAGTCTGTGCAA-1	LowQuality
ACATGGTAGGGCTTGA-1	GoodQuality
ACATGGTAGTTTAGGA-1	LowQuality
ACATGGTCAAGCTGAG-1	GoodQuality
ACATGGTCACAACTGT-1	GoodQuality
ACATGGTCAGTCAGAG-1	GoodQuality
ACATGGTGTATATCCG-1	GoodQuality
ACATGGTGTTAAGACA-1	LowQuality
ACATGGTTCTTGTCAT-1	LowQuality
ACCAGTAAGACGCTTT-1	LowQuality
ACCAGTAAGATGAGAG-1	LowQuality
ACCAGTAAGTAGCCGA-1	GoodQuality
ACCAGTACACTTACGA-1	GoodQuality
ACCAGTACAGCTTCGG-1	GoodQuality
ACCAGTACAGTTTACG-1	GoodQuality
ACCAGTACATACGCCG-1	GoodQuality
ACCAGTACATACTCTT-1	GoodQuality
ACCAGTACATAGACTC-1	GoodQuality
ACCAGTATCCCAAGAT-1	GoodQuality
ACCAGTATCCGAATGT-1	GoodQuality
ACCAGTATCGTCACGG-1	GoodQuality
ACCCACTAGAAGGGTA-1	GoodQuality
ACCCACTAGCACCGCT-1	GoodQuality
ACCCACTAGGACGAAA-1	LowQuality
ACCCACTAGTGCGATG-1	GoodQuality
ACCCACTCAGGATTGG-1	LowQuality
ACCCACTCAGGCAGTA-1	LowQuality
ACCCACTCATTCTCAT-1	GoodQuality
ACCCACTCATTTCAGG-1	LowQuality
ACCCACTGTAGGGACT-1	GoodQuality
ACCCACTGTCCGAAGA-1	LowQuality
ACCCACTGTCTAGCCG-1	LowQuality
ACCCACTGTGCAGGTA-1	GoodQuality
ACCCACTGTGTCGCTG-1	GoodQuality
ACCCACTTCATCACCC-1	LowQuality
ACCCACTTCTGTGCAA-1	GoodQuality
ACCGTAAAGACGCAAC-1	LowQuality
ACCGTAAAGCATGGCA-1	LowQuality
ACCGTAAAGGAATTAC-1	GoodQuality
ACCGTAAAGGGCTTGA-1	GoodQuality
ACCGTAACAACGATGG-1	GoodQuality
ACCGTAACACATGACT-1	LowQuality
ACCGTAACATACTACG-1	GoodQuality
ACCGTAAGTAAGGGCT-1	LowQuality
ACCGTAAGTACCAGTT-1	GoodQuality
ACCGTAAGTATGGTTC-1	LowQuality
ACCGTAAGTGAGGGTT-1	GoodQuality
ACCTTTAAGACCTAGG-1	GoodQuality
ACCTTTAAGATGTGGC-1	GoodQuality
ACCTTTAAGCTGCCCA-1	GoodQuality
ACCTTTAAGGAACTGC-1	GoodQuality
ACCTTTACAAGCTGAG-1	GoodQuality
ACCTTTACAATGGAAT-1	GoodQuality
ACCTTTACAGCCACCA-1	LowQuality
ACCTTTACAGGACGTA-1	GoodQuality
ACCTTTAGTAGCCTCG-1	GoodQuality
ACCTTTAGTAGGGTAC-1	LowQuality
ACCTTTAGTGCAGGTA-1	GoodQuality
ACCTTTAGTTACGACT-1	GoodQuality
ACCTTTATCACGATGT-1	LowQuality
ACCTTTATCGCAGGCT-1	GoodQuality
ACGAGCCAGCAGACTG-1	GoodQuality
ACGAGCCAGGACAGAA-1	GoodQuality
ACGAGCCAGTACGCGA-1	GoodQuality
ACGAGCCAGTCTCAAC-1	LowQuality
ACGAGCCCACCGATAT-1	GoodQuality
ACGAGCCGTAAGGGAA-1	GoodQuality
ACGAGCCGTCGCATCG-1	LowQuality
ACGAGCCGTGATAAAC-1	GoodQuality
ACGAGCCGTGTAAGTA-1	GoodQuality
ACGAGCCGTGTTTGGT-1	GoodQuality
ACGAGCCGTTTGTTGG-1	GoodQuality
ACGAGCCTCAAACCGT-1	LowQuality
ACGAGCCTCCCTAATT-1	GoodQuality
ACGAGCCTCGCCTGTT-1	GoodQuality
ACGAGCCTCTTCAACT-1	GoodQuality
ACGAGGAAGAGATGAG-1	GoodQuality
ACGAGGAAGATGTGTA-1	GoodQuality
ACGAGGAAGCGCCTTG-1	GoodQuality
ACGAGGAAGCTGATAA-1	LowQuality
ACGAGGAAGGCCCTCA-1	GoodQuality
ACGAGGAAGGCGACAT-1	LowQuality
ACGAGGACAACTTGAC-1	LowQuality
ACGAGGACAATGGAAT-1	GoodQuality
ACGAGGACAGCTGTGC-1	LowQuality
ACGAGGACAGGACGTA-1	GoodQuality
ACGAGGACATCGATTG-1	GoodQuality
ACGAGGACATCTCGCT-1	GoodQuality
ACGAGGACATGCGCAC-1	GoodQuality
ACGAGGAGTACAGACG-1	GoodQuality
ACGAGGAGTACCGTAT-1	GoodQuality
ACGAGGAGTGCGCTTG-1	GoodQuality
ACGAGGATCCGCGTTT-1	GoodQuality
ACGATACAGAATGTGT-1	GoodQuality
ACGATACAGAATTCCC-1	LowQuality
ACGATACCAAAGGAAG-1	GoodQuality
ACGATACCATCCTTGC-1	GoodQuality
ACGATACTCACCCGAG-1	GoodQuality
ACGATACTCTAACTTC-1	GoodQuality
ACGATGTAGAATTGTG-1	LowQuality
ACGATGTAGGAACTGC-1	LowQuality
ACGATGTAGGTGCACA-1	GoodQuality
ACGATGTCAATCCGAT-1	LowQuality
ACGATGTCACCAACCG-1	GoodQuality
ACGATGTCAGTCAGAG-1	LowQuality
ACGATGTGTCGCTTTC-1	GoodQuality
ACGATGTGTCTCCCTA-1	GoodQuality
ACGATGTTCAAACAAG-1	GoodQuality
ACGATGTTCAACGCTA-1	GoodQuality
ACGATGTTCAAGGCTT-1	GoodQuality
ACGATGTTCATGTGGT-1	LowQuality
ACGATGTTCTCAAACG-1	GoodQuality
ACGCAGCAGTATGACA-1	LowQuality
ACGCAGCAGTGTCTCA-1	GoodQuality
ACGCAGCCAGATGGGT-1	GoodQuality
ACGCAGCCATCGATTG-1	LowQuality
ACGCAGCGTAATCGTC-1	LowQuality
ACGCAGCGTCCAGTGC-1	LowQuality
ACGCAGCGTCTGCGGT-1	GoodQuality
ACGCAGCGTGGTACAG-1	LowQuality
ACGCAGCTCATGTCTT-1	GoodQuality
ACGCAGCTCCGTCATC-1	GoodQuality
ACGCAGCTCCTGTAGA-1	LowQuality
ACGCAGCTCGTTACGA-1	GoodQuality
ACGCCAGAGAAGGCCT-1	GoodQuality
ACGCCAGAGATCCCAT-1	GoodQuality
ACGCCAGCAGATCTGT-1	LowQuality
ACGCCAGGTAAGCACG-1	GoodQuality
ACGCCAGGTGGTTTCA-1	GoodQuality
ACGCCAGGTGTGACGA-1	LowQuality
ACGCCAGGTGTGGCTC-1	GoodQuality
ACGCCAGGTTCATGGT-1	LowQuality
ACGCCAGTCAACACTG-1	GoodQuality
ACGCCGAAGAGGTAGA-1	LowQuality
ACGCCGAAGATCGATA-1	LowQuality
ACGCCGAAGCGTCAAG-1	GoodQuality
ACGCCGAAGCTAAACA-1	GoodQuality
ACGCCGACACCGGAAA-1	GoodQuality
ACGCCGACACGTGAGA-1	GoodQuality
ACGCCGACAGAGCCAA-1	GoodQuality
ACGCCGACAGGTCGTC-1	GoodQuality
ACGCCGAGTAAACGCG-1	LowQuality
ACGCCGAGTCTCAACA-1	GoodQuality
ACGCCGATCAGCGATT-1	GoodQuality
ACGGAGAAGTACGCCC-1	GoodQuality
ACGGAGACATGGTCTA-1	GoodQuality
ACGGAGAGTAGAGGAA-1	GoodQuality
ACGGAGAGTCAGGACA-1	GoodQuality
ACGGAGAGTCGCGTGT-1	LowQuality
ACGGAGATCGAGAACG-1	GoodQuality
ACGGAGATCGGACAAG-1	GoodQuality
ACGGAGATCGTGGGAA-1	GoodQuality
ACGGAGATCTGGAGCC-1	GoodQuality
ACGGAGATCTTGGGTA-1	LowQuality
ACGGCCAAGTCTCAAC-1	GoodQuality
ACGGCCAAGTGAAGAG-1	GoodQuality
ACGGCCAAGTGCCATT-1	GoodQuality
ACGGCCACATCGTCGG-1	GoodQuality
ACGGCCAGTGGTGTAG-1	GoodQuality
ACGGCCATCCATGAAC-1	GoodQuality
ACGGCCATCTATCCTA-1	GoodQuality
ACGGCCATCTGCTGCT-1	GoodQuality
ACGGGCTAGAAGGACA-1	LowQuality
ACGGGCTAGAATCTCC-1	GoodQuality
ACGGGCTAGATGTCGG-1	GoodQuality
ACGGGCTAGTAGCCGA-1	LowQuality
ACGGGCTAGTGCGTGA-1	LowQuality
ACGGGCTCAACGATCT-1	GoodQuality
ACGGGCTCAAGAAAGG-1	GoodQuality
ACGGGCTCAGGAACGT-1	GoodQuality
ACGGGCTGTACACCGC-1	GoodQuality
ACGGGCTGTACAGTGG-1	GoodQuality
ACGGGCTTCACATAGC-1	LowQuality
ACGGGCTTCACATGCA-1	GoodQuality
ACGGGCTTCCATGCTC-1	LowQuality
ACGGGCTTCGAGCCCA-1	LowQuality
ACGGGCTTCGCATGGC-1	GoodQuality
ACGGGCTTCGTTGACA-1	GoodQuality
ACGGGTCAGAGACGAA-1	GoodQuality
ACGGGTCAGATAGGAG-1	LowQuality
ACGGGTCAGCCAGAAC-1	GoodQuality
ACGGGTCCAATGGATA-1	GoodQuality
ACGGGTCCAGTAAGCG-1	GoodQuality
ACGGGTCCATCGGAAG-1	GoodQuality
ACGGGTCCATGAACCT-1	GoodQuality
ACGGGTCGTATGAATG-1	GoodQuality
ACGGGTCGTCCAACTA-1	GoodQuality
ACGGGTCGTCTAGCGC-1	GoodQuality
ACGGGTCGTCTCATCC-1	GoodQuality
ACGGGTCTCTAACTTC-1	GoodQuality
ACGGGTCTCTCGGACG-1	LowQuality
ACGTCAAAGAGTACAT-1	LowQuality
ACGTCAAAGCACACAG-1	LowQuality
ACGTCAAAGTGGGATC-1	LowQuality
ACGTCAACAATTGCTG-1	GoodQuality
ACGTCAACACAGACTT-1	GoodQuality
ACGTCAACATAAAGGT-1	GoodQuality
ACGTCAACATCGGAAG-1	GoodQuality
ACGTCAAGTCAATGTC-1	LowQuality
ACGTCAAGTCCAGTGC-1	LowQuality
ACGTCAAGTTGGTTTG-1	LowQuality
ACGTCAATCAAACCAC-1	GoodQuality
ACGTCAATCACCTCGT-1	GoodQuality
ACGTCAATCGTAGGTT-1	GoodQuality
ACGTCAATCTAACCGA-1	GoodQuality
ACGTCAATCTAGAGTC-1	GoodQuality
ACGTCAATCTATCCTA-1	GoodQuality
ACGTCAATCTGGAGCC-1	LowQuality
ACTATCTAGAACAATC-1	GoodQuality
ACTATCTAGAGACTTA-1	GoodQuality
ACTATCTAGGGATCTG-1	GoodQuality
ACTATCTAGGTGGGTT-1	GoodQuality
ACTATCTAGTGGTAAT-1	LowQuality
ACTATCTCAAAGGTGC-1	GoodQuality
ACTATCTCAAAGTCAA-1	LowQuality
ACTATCTCACGGCGTT-1	GoodQuality
ACTATCTCAGCTGCTG-1	GoodQuality
ACTATCTGTAAGAGAG-1	GoodQuality
ACTATCTGTATATGAG-1	LowQuality
ACTATCTGTCTCCACT-1	GoodQuality
ACTATCTGTGTGGCTC-1	GoodQuality
ACTATCTGTTCGTTGA-1	GoodQuality
ACTATCTTCATAGCAC-1	GoodQuality
ACTATCTTCATCATTC-1	GoodQuality
ACTATCTTCCGATATG-1	LowQuality
ACTATCTTCTATGTGG-1	LowQuality
ACTATCTTCTTTAGGG-1	LowQuality
ACTGAACAGAAACGCC-1	LowQuality
ACTGAACAGACTAAGT-1	GoodQuality
ACTGAACCAAATTGCC-1	LowQuality
ACTGAACCAGATGGGT-1	GoodQuality
ACTGAACCATCTCCCA-1	LowQuality
ACTGAACGTATATGGA-1	GoodQuality
ACTGAACGTCCTAGCG-1	GoodQuality
ACTGAACGTCGACTAT-1	GoodQuality
ACTGAACGTGAGGGTT-1	GoodQuality
ACTGAACTCAGGTTCA-1	LowQuality
ACTGAACTCCTTGCCA-1	GoodQuality
ACTGAACTCTCGTTTA-1	GoodQuality
ACTGAGTAGATGTGTA-1	GoodQuality
ACTGAGTCACATTAGC-1	GoodQuality
ACTGAGTGTACCGTAT-1	LowQuality
ACTGAGTGTCGGCACT-1	GoodQuality
ACTGAGTGTTCAGGCC-1	LowQuality
ACTGAGTGTTGGACCC-1	LowQuality
ACTGAGTTCAACCAAC-1	LowQuality
ACTGAGTTCAGTTAGC-1	GoodQuality
ACTGAGTTCCCTAATT-1	LowQuality
ACTGAGTTCTGATTCT-1	GoodQuality
ACTGATGAGCAGGCTA-1	GoodQuality
ACTGATGAGCGAAGGG-1	GoodQuality
ACTGATGAGTCAAGGC-1	LowQuality
ACTGATGCAACACCCG-1	LowQuality
ACTGATGCAATGGAGC-1	GoodQuality
ACTGATGCATGCCCGA-1	GoodQuality
ACTGATGGTACCAGTT-1	GoodQuality
ACTGATGGTACTCGCG-1	LowQuality
ACTGATGGTAGTACCT-1	GoodQuality
ACTGATGGTATAATGG-1	LowQuality
ACTGATGGTCGACTGC-1	GoodQuality
ACTGATGTCACATGCA-1	GoodQuality
ACTGATGTCCTGTAGA-1	GoodQuality
ACTGCTCAGACACTAA-1	GoodQuality
ACTGCTCAGACTACAA-1	GoodQuality
ACTGCTCAGATGTAAC-1	GoodQuality
ACTGCTCAGCACCGCT-1	LowQuality
ACTGCTCAGCCTATGT-1	GoodQuality
ACTGCTCAGGTAAACT-1	GoodQuality
ACTGCTCAGGTGCACA-1	LowQuality
ACTGCTCAGTGATCGG-1	GoodQuality
ACTGCTCAGTTAGGTA-1	GoodQuality
ACTGCTCCAATCCAAC-1	GoodQuality
ACTGCTCCACAAGACG-1	GoodQuality
ACTGCTCCATACAGCT-1	GoodQuality
ACTGCTCGTCTAGTCA-1	GoodQuality
ACTGCTCGTGTTGAGG-1	GoodQuality
ACTGCTCTCACCTTAT-1	GoodQuality
ACTGCTCTCAGTTCGA-1	LowQuality
ACTGCTCTCGCAGGCT-1	GoodQuality
ACTGTCCAGACCCACC-1	GoodQuality
ACTGTCCAGACTACAA-1	LowQuality
ACTGTCCAGACTTGAA-1	LowQuality
ACTGTCCAGAGACGAA-1	GoodQuality
ACTGTCCAGAGTTGGC-1	GoodQuality
ACTGTCCAGTGTCCAT-1	GoodQuality
ACTGTCCCAACTGCTA-1	LowQuality
ACTGTCCCATTGAGCT-1	GoodQuality
ACTGTCCGTAATCACC-1	GoodQuality
ACTGTCCGTCGAACAG-1	GoodQuality
ACTGTCCGTCTGGAGA-1	LowQuality
ACTGTCCGTGCGGTAA-1	GoodQuality
ACTGTCCTCAGTGTTG-1	GoodQuality
ACTGTCCTCCATGAGT-1	GoodQuality
ACTGTCCTCCCTAATT-1	GoodQuality
ACTGTCCTCTCTAGGA-1	GoodQuality
ACTTACTAGAAACGAG-1	GoodQuality
ACTTACTAGACCACGA-1	GoodQuality
ACTTACTAGAGCCCAA-1	LowQuality
ACTTACTAGCACCGTC-1	GoodQuality
ACTTACTCAAGACACG-1	GoodQuality
ACTTACTCAGCCTTTC-1	GoodQuality
ACTTACTCAGGATCGA-1	GoodQuality
ACTTACTGTACCGTTA-1	LowQuality
ACTTACTGTGGGTATG-1	GoodQuality
ACTTACTTCCCAGGTG-1	LowQuality
ACTTACTTCTACTTAC-1	LowQuality
ACTTACTTCTGTGCAA-1	GoodQuality
ACTTGTTAGAAGATTC-1	GoodQuality
ACTTGTTCAAACGTGG-1	GoodQuality
ACTTGTTCAGATCTGT-1	GoodQuality
ACTTGTTCAGGGTTAG-1	GoodQuality
ACTTGTTCATGTCCTC-1	GoodQuality
ACTTGTTGTAGCGTGA-1	GoodQuality
ACTTGTTGTCCAGTGC-1	GoodQuality
ACTTGTTGTGGTTTCA-1	LowQuality
ACTTGTTGTTAAGTAG-1	LowQuality
ACTTGTTTCACATGCA-1	GoodQuality
ACTTGTTTCCCAAGTA-1	GoodQuality
ACTTGTTTCCTCATTA-1	GoodQuality
ACTTGTTTCGCGGATC-1	GoodQuality
ACTTGTTTCGCTGATA-1	GoodQuality
ACTTTCAAGCGCTCCA-1	GoodQuality
ACTTTCAAGGAGTAGA-1	GoodQuality
ACTTTCAAGGAGTCTG-1	GoodQuality
ACTTTCAAGGCTAGGT-1	GoodQuality
ACTTTCAAGGGCACTA-1	GoodQuality
ACTTTCAAGTCAAGCG-1	GoodQuality
ACTTTCACAAGCCCAC-1	LowQuality
ACTTTCACAGGCTGAA-1	GoodQuality
ACTTTCACAGTGACAG-1	GoodQuality
ACTTTCAGTAAGGGCT-1	LowQuality
ACTTTCAGTAGTGAAT-1	LowQuality
ACTTTCAGTCCAGTAT-1	GoodQuality
ACTTTCAGTCGGATCC-1	GoodQuality
ACTTTCAGTCTGCAAT-1	GoodQuality
ACTTTCAGTGCCTGTG-1	GoodQuality
ACTTTCAGTTACGCGC-1	GoodQuality
ACTTTCAGTTCAGCGC-1	GoodQuality
ACTTTCAGTTGTTTGG-1	GoodQuality
ACTTTCATCCGCATAA-1	GoodQuality
ACTTTCATCTTCAACT-1	LowQuality
AGAATAGAGAAACGAG-1	GoodQuality
AGAATAGAGCGCCTTG-1	GoodQuality
AGAATAGAGCGTTTAC-1	LowQuality
AGAATAGAGGTGCTAG-1	GoodQuality
AGAATAGAGTGGGATC-1	GoodQuality
AGAATAGCACCAGCAC-1	GoodQuality
AGAATAGCAGAGCCAA-1	LowQuality
AGAATAGCAGTAAGCG-1	GoodQuality
AGAATAGGTATCACCA-1	GoodQuality
AGAATAGGTCGACTGC-1	GoodQuality
AGAATAGTCGAGGTAG-1	GoodQuality
AGACGTTAGATCACGG-1	LowQuality
AGACGTTAGTGTGGCA-1	GoodQuality
AGACGTTCATCCGGGT-1	GoodQuality
AGACGTTCATGGTTGT-1	GoodQuality
AGACGTTGTACGACCC-1	GoodQuality
AGACGTTGTAGCTCCG-1	GoodQuality
AGACGTTTCGGAGGTA-1	GoodQuality
AGACGTTTCGTCCGTT-1	GoodQuality
AGAGCGAAGACTTTCG-1	GoodQuality
AGAGCGAAGAGGACGG-1	GoodQuality
AGAGCGAAGATGCCTT-1	GoodQuality
AGAGCGAAGCAATCTC-1	GoodQuality
AGAGCGACACGGTAGA-1	GoodQuality
AGAGCGACACTCGACG-1	GoodQuality
AGAGCGACAGGCAGTA-1	GoodQuality
AGAGCGAGTCTGATTG-1	LowQuality
AGAGCGAGTGTCAATC-1	GoodQuality
AGAGCGAGTGTTTGGT-1	GoodQuality
AGAGCGATCAGTTTGG-1	GoodQuality
AGAGCGATCGGAGCAA-1	LowQuality
AGAGCTTAGAGTCGGT-1	GoodQuality
AGAGCTTCATATGGTC-1	GoodQuality
AGAGCTTCATGGAATA-1	GoodQuality
AGAGCTTGTATCTGCA-1	GoodQuality
AGAGCTTGTCAAACTC-1	GoodQuality
AGAGCTTTCATCGGAT-1	GoodQuality
AGAGCTTTCTCCAACC-1	GoodQuality
AGAGCTTTCTCCAGGG-1	GoodQuality
AGAGTGGAGAACAACT-1	GoodQuality
AGAGTGGCAAGTCATC-1	GoodQuality
AGAGTGGCACTTAAGC-1	LowQuality
AGAGTGGCAGTACACT-1	GoodQuality
AGAGTGGCATGAACCT-1	GoodQuality
AGAGTGGCATGGTCTA-1	LowQuality
AGAGTGGGTATGCTTG-1	GoodQuality
AGAGTGGGTCCAGTAT-1	GoodQuality
AGAGTGGGTCCAGTTA-1	LowQuality
AGAGTGGGTGCTGTAT-1	LowQuality
AGAGTGGGTTTAGGAA-1	GoodQuality
AGAGTGGTCCGAGCCA-1	LowQuality
AGAGTGGTCCTCAATT-1	GoodQuality
AGAGTGGTCTTCGAGA-1	LowQuality
AGATCTGAGAGTACAT-1	LowQuality
AGATCTGAGATGTGGC-1	GoodQuality
AGATCTGAGCAGACTG-1	GoodQuality
AGATCTGAGCAGGTCA-1	GoodQuality
AGATCTGAGCTAGTCT-1	GoodQuality
AGATCTGCAAACTGCT-1	LowQuality
AGATCTGCACAACTGT-1	GoodQuality
AGATCTGCAGGCGATA-1	GoodQuality
AGATCTGGTATGAAAC-1	GoodQuality
AGATCTGGTCCAGTTA-1	LowQuality
AGATCTGGTCTGCAAT-1	LowQuality
AGATCTGGTTTAGGAA-1	GoodQuality
AGATCTGTCCCACTTG-1	LowQuality
AGATTGCAGCGTTTAC-1	GoodQuality
AGATTGCCATGTCGAT-1	LowQuality
AGATTGCGTAACGTTC-1	LowQuality
AGATTGCGTAGCCTAT-1	GoodQuality
AGATTGCGTCGCGGTT-1	LowQuality
AGATTGCGTGAGGGAG-1	GoodQuality
AGATTGCGTTATGTGC-1	LowQuality
AGATTGCTCACAACGT-1	LowQuality
AGATTGCTCACGAAGG-1	GoodQuality
AGATTGCTCATCATTC-1	GoodQuality
AGATTGCTCATTATCC-1	GoodQuality
AGATTGCTCCGCAGTG-1	GoodQuality
AGCAGCCAGACTGGGT-1	GoodQuality
AGCAGCCAGATATGGT-1	LowQuality
AGCAGCCAGCTAAACA-1	GoodQuality
AGCAGCCAGGTCGGAT-1	GoodQuality
AGCAGCCCACTGTGTA-1	GoodQuality
AGCAGCCCAGCCAATT-1	GoodQuality
AGCAGCCCATGAGCGA-1	GoodQuality
AGCAGCCGTAAGAGGA-1	LowQuality
AGCAGCCGTCTTCAAG-1	LowQuality
AGCAGCCGTTATCGGT-1	GoodQuality
AGCAGCCTCATGTCCC-1	LowQuality
AGCAGCCTCTCACATT-1	GoodQuality
AGCATACAGACCTAGG-1	LowQuality
AGCATACAGCGCTCCA-1	GoodQuality
AGCATACAGGTGATAT-1	GoodQuality
AGCATACAGTTTAGGA-1	LowQuality
AGCATACCAAATCCGT-1	LowQuality
AGCATACCAACGATGG-1	GoodQuality
AGCATACCAGCTCCGA-1	GoodQuality
AGCATACCATACTCTT-1	LowQuality
AGCATACGTACTCAAC-1	GoodQuality
AGCATACGTCACTGGC-1	GoodQuality
AGCATACGTTTACTCT-1	GoodQuality
AGCATACTCACATACG-1	GoodQuality
AGCATACTCGAGAGCA-1	GoodQuality
AGCATACTCGCGTAGC-1	GoodQuality
AGCCTAAAGACTTTCG-1	GoodQuality
AGCCTAAAGATAGCAT-1	LowQuality
AGCCTAAAGATAGGAG-1	GoodQuality
AGCCTAAAGATGCGAC-1	LowQuality
AGCCTAAAGCCGATTT-1	GoodQuality
AGCCTAACAAGCCATT-1	GoodQuality
AGCCTAACAATGAATG-1	GoodQuality
AGCCTAACAGACGCAA-1	GoodQuality
AGCCTAACAGCGAACA-1	GoodQuality
AGCCTAACATATGAGA-1	LowQuality
AGCCTAAGTAGCTGCC-1	LowQuality
AGCCTAAGTGCACTTA-1	GoodQuality
AGCCTAAGTTCACCTC-1	LowQuality
AGCCTAAGTTCCCTTG-1	GoodQuality
AGCCTAATCATGGTCA-1	LowQuality
AGCGGTCAGCCGCCTA-1	GoodQuality
AGCGGTCAGCGATAGC-1	LowQuality
AGCGGTCAGCTTCGCG-1	GoodQuality
AGCGGTCAGCTTTGGT-1	GoodQuality
AGCGGTCAGGGCTTGA-1	GoodQuality
AGCGGTCAGTGAAGTT-1	GoodQuality
AGCGGTCAGTGCGTGA-1	GoodQuality
AGCGGTCAGTTCGCGC-1	LowQuality
AGCGGTCCAGAGTGTG-1	GoodQuality
AGCGGTCCAGTGGAGT-1	LowQuality
AGCGGTCGTAGCGTGA-1	GoodQuality
AGCGGTCGTAGGGACT-1	GoodQuality
AGCGGTCGTATGAATG-1	LowQuality
AGCGGTCGTTGGTAAA-1	GoodQuality
AGCGGTCTCAGTGCAT-1	GoodQuality
AGCGGTCTCGGATGGA-1	LowQuality
AGCGGTCTCTGCTGCT-1	GoodQuality
AGCGTATAGAATAGGG-1	GoodQuality
AGCGTATAGCTAACTC-1	GoodQuality
AGCGTATAGCTCAACT-1	GoodQuality
AGCGTATAGTGGCACA-1	GoodQuality
AGCGTATCAAGCTGTT-1	GoodQuality
AGCGTATCACATTAGC-1	GoodQuality
AGCGTATCACCGTTGG-1	GoodQuality
AGCGTATCACCTGGTG-1	GoodQuality
AGCGTATCAGCCTGTG-1	GoodQuality
AGCGTATCAGTAACGG-1	LowQuality
AGCGTATGTAAATGTG-1	GoodQuality
AGCGTATGTATTCGTG-1	LowQuality
AGCGTATGTCCGTGAC-1	GoodQuality
AGCGTATGTTTGACAC-1	GoodQuality
AGCGTATTCACAATGC-1	GoodQuality
AGCGTATTCAGGCCCA-1	LowQuality
AGCGTATTCCACGCAG-1	LowQuality
AGCGTATTCTCCCTGA-1	GoodQuality
AGCGTCGCACATCCGG-1	GoodQuality
AGCGTCGCAGACAAAT-1	LowQuality
AGCGTCGCAGCGAACA-1	LowQuality
AGCGTCGGTCATCCCT-1	GoodQuality
AGCGTCGGTGAAGGCT-1	GoodQuality
AGCGTCGTCAACACGT-1	GoodQuality
AGCGTCGTCATTATCC-1	GoodQuality
AGCGTCGTCCGCGGTA-1	GoodQuality
AGCGTCGTCCGTCAAA-1	GoodQuality
AGCGTCGTCCTTTACA-1	GoodQuality
AGCGTCGTCTTCGGTC-1	GoodQuality
AGCTCCTAGACCTAGG-1	GoodQuality
AGCTCCTAGAGAACAG-1	GoodQuality
AGCTCCTAGGTGCAAC-1	GoodQuality
AGCTCCTCAATGTTGC-1	GoodQuality
AGCTCCTCACCCAGTG-1	GoodQuality
AGCTCCTCAGTGAGTG-1	GoodQuality
AGCTCCTCATACTACG-1	LowQuality
AGCTCCTGTAAACCTC-1	GoodQuality
AGCTCCTGTATATCCG-1	GoodQuality
AGCTCCTGTATCACCA-1	LowQuality
AGCTCCTGTCGACTGC-1	GoodQuality
AGCTCCTGTCTGGAGA-1	GoodQuality
AGCTCCTGTCTTGCGG-1	GoodQuality
AGCTCCTGTTCAGTAC-1	GoodQuality
AGCTCCTTCAGGATCT-1	GoodQuality
AGCTCCTTCTAGCACA-1	GoodQuality
AGCTCCTTCTGAGGGA-1	GoodQuality
AGCTCCTTCTTGTTTG-1	GoodQuality
AGCTCTCAGCAGACTG-1	LowQuality
AGCTCTCAGCTGCCCA-1	GoodQuality
AGCTCTCAGCTGTTCA-1	GoodQuality
AGCTCTCAGGATATAC-1	GoodQuality
AGCTCTCAGGCAATTA-1	GoodQuality
AGCTCTCAGGTAGCTG-1	GoodQuality
AGCTCTCCAATTGCTG-1	LowQuality
AGCTCTCGTAAACGCG-1	GoodQuality
AGCTCTCGTAAGGATT-1	GoodQuality
AGCTCTCGTCACTTCC-1	LowQuality
AGCTCTCGTCGGCACT-1	LowQuality
AGCTCTCGTCTTCGTC-1	GoodQuality
AGCTCTCGTGTCAATC-1	GoodQuality
AGCTCTCGTTCCATGA-1	GoodQuality
AGCTCTCTCATCATTC-1	GoodQuality
AGCTCTCTCCGCAGTG-1	GoodQuality
AGCTCTCTCGCACTCT-1	GoodQuality
AGCTTGAAGAAACCTA-1	LowQuality
AGCTTGAAGGGATGGG-1	GoodQuality
AGCTTGAAGTACATGA-1	GoodQuality
AGCTTGAAGTGTTTGC-1	GoodQuality
AGCTTGACAACGCACC-1	GoodQuality
AGCTTGACAAGCTGGA-1	GoodQuality
AGCTTGACACGACTCG-1	LowQuality
AGCTTGACACTTGGAT-1	GoodQuality
AGCTTGACAGAAGCAC-1	GoodQuality
AGCTTGACAGTCACTA-1	GoodQuality
AGCTTGACAGTGAGTG-1	LowQuality
AGCTTGAGTCATCCCT-1	GoodQuality
AGCTTGAGTTCGCGAC-1	GoodQuality
AGCTTGAGTTGTACAC-1	LowQuality
AGCTTGATCACTTACT-1	GoodQuality
AGCTTGATCCTTCAAT-1	GoodQuality
AGGCCACAGATCCTGT-1	LowQuality
AGGCCACAGTGGCACA-1	GoodQuality
AGGCCACCACAAGTAA-1	LowQuality
AGGCCACCACGAAATA-1	GoodQuality
AGGCCACGTCACCTAA-1	GoodQuality
AGGCCACGTCCCGACA-1	GoodQuality
AGGCCACGTTATTCTC-1	LowQuality
AGGCCACGTTCAGACT-1	GoodQuality
AGGCCACTCCGGCACA-1	LowQuality
AGGCCACTCGTTTAGG-1	GoodQuality
AGGCCACTCTACCAGA-1	GoodQuality
AGGCCACTCTTGACGA-1	GoodQuality
AGGCCGTAGGTGTGGT-1	GoodQuality
AGGCCGTCAAGGACAC-1	GoodQuality
AGGCCGTCACAGAGGT-1	GoodQuality
AGGCCGTCAGCAGTTT-1	GoodQuality
AGGCCGTGTCCAAGTT-1	GoodQuality
AGGCCGTGTTGAGTTC-1	GoodQuality
AGGCCGTTCACCGGGT-1	GoodQuality
AGGCCGTTCAGTTCGA-1	GoodQuality
AGGCCGTTCATCGGAT-1	GoodQuality
AGGCCGTTCGTCCGTT-1	GoodQuality
AGGGAGTCAATAACGA-1	GoodQuality
AGGGAGTCACTCAGGC-1	GoodQuality
AGGGAGTGTAGCACGA-1	GoodQuality
AGGGAGTGTAGCTGCC-1	GoodQuality
AGGGAGTGTAGTGAAT-1	GoodQuality
AGGGAGTGTATAGTAG-1	GoodQuality
AGGGAGTGTCCATGAT-1	LowQuality
AGGGAGTGTCCGTCAG-1	GoodQuality
AGGGAGTGTCTAGAGG-1	GoodQuality
AGGGAGTTCGAACGGA-1	LowQuality
AGGGAGTTCGCAAGCC-1	GoodQuality
AGGGAGTTCTCAAACG-1	LowQuality
AGGGATGAGACAAAGG-1	GoodQuality
AGGGATGAGACATAAC-1	LowQuality
AGGGATGAGGTGTGGT-1	GoodQuality
AGGGATGAGTGTACGG-1	GoodQuality
AGGGATGAGTTAACGA-1	GoodQuality
AGGGATGCAGCTGCAC-1	GoodQuality
AGGGATGCATGTTGAC-1	LowQuality
AGGGATGCATTCCTGC-1	GoodQuality
AGGGATGTCAACGCTA-1	GoodQuality
AGGGATGTCACATAGC-1	GoodQuality
AGGGATGTCAGTACGT-1	GoodQuality
AGGGATGTCGTTTAGG-1	GoodQuality
AGGGATGTCTGTCCGT-1	GoodQuality
AGGGTGAAGATGCGAC-1	GoodQuality
AGGGTGAAGCGATGAC-1	LowQuality
AGGGTGACACATGGGA-1	GoodQuality
AGGGTGACACGAAACG-1	GoodQuality
AGGGTGACAGACTCGC-1	GoodQuality
AGGGTGAGTATAATGG-1	GoodQuality
AGGGTGAGTGCACTTA-1	GoodQuality
AGGGTGAGTGCCTGCA-1	GoodQuality
AGGGTGATCCTTGACC-1	LowQuality
AGGGTGATCTGCCCTA-1	LowQuality
AGGGTGATCTTTAGGG-1	LowQuality
AGGTCATAGACCTTTG-1	LowQuality
AGGTCATAGCGTTTAC-1	LowQuality
AGGTCATAGGGCTCTC-1	GoodQuality
AGGTCATAGGGTTCCC-1	GoodQuality
AGGTCATAGTGTTGAA-1	GoodQuality
AGGTCATCATCCAACA-1	GoodQuality
AGGTCATGTAAGAGAG-1	GoodQuality
AGGTCATGTACCATCA-1	LowQuality
AGGTCATGTAGAAAGG-1	GoodQuality
AGGTCATGTATGAATG-1	LowQuality
AGGTCATGTCAGAAGC-1	LowQuality
AGGTCATGTGGTCCGT-1	LowQuality
AGGTCATGTGTCTGAT-1	LowQuality
AGGTCATGTTACTGAC-1	GoodQuality
AGGTCATGTTCCAACA-1	LowQuality
AGGTCATTCAACACCA-1	LowQuality
AGGTCATTCCTGTACC-1	GoodQuality
AGGTCATTCTCCAGGG-1	GoodQuality
AGGTCCGAGACGCTTT-1	GoodQuality
AGGTCCGAGACTAGAT-1	GoodQuality
AGGTCCGAGCTGGAAC-1	LowQuality
AGGTCCGAGGTGTTAA-1	LowQuality
AGGTCCGAGTGCCATT-1	GoodQuality
AGGTCCGCAAGCCGCT-1	GoodQuality
AGGTCCGCAAGGACAC-1	LowQuality
AGGTCCGGTTCATGGT-1	GoodQuality
AGGTCCGTCAACGGCC-1	GoodQuality
AGGTCCGTCAAGCCTA-1	GoodQuality
AGGTCCGTCGGTGTTA-1	GoodQuality
AGGTCCGTCTCATTCA-1	LowQuality
AGGTCCGTCTGGAGCC-1	GoodQuality
AGTAGTCAGTGGTAAT-1	GoodQuality
AGTAGTCCAAACCCAT-1	GoodQuality
AGTAGTCCACACCGCA-1	GoodQuality
AGTAGTCCACCAGCAC-1	GoodQuality
AGTAGTCCAGGTGGAT-1	GoodQuality
AGTAGTCCATGTTGAC-1	LowQuality
AGTAGTCGTAAAGTCA-1	GoodQuality
AGTAGTCGTCGACTAT-1	LowQuality
AGTAGTCGTCTGGAGA-1	GoodQuality
AGTAGTCGTGCACCAC-1	GoodQuality
AGTAGTCGTGCTGTAT-1	GoodQuality
AGTAGTCTCCCTAACC-1	LowQuality
AGTCTTTAGGCTCTTA-1	GoodQuality
AGTCTTTAGGGATCTG-1	GoodQuality
AGTCTTTAGGGCACTA-1	GoodQuality
AGTCTTTAGTCTCCTC-1	GoodQuality
AGTCTTTAGTGTACGG-1	GoodQuality
AGTCTTTCAATGGAGC-1	GoodQuality
AGTCTTTCACACCGCA-1	GoodQuality
AGTCTTTCACCAGATT-1	GoodQuality
AGTCTTTCAGGTGCCT-1	GoodQuality
AGTCTTTGTACCCAAT-1	GoodQuality
AGTCTTTGTACCGAGA-1	GoodQuality
AGTCTTTGTAGCTCCG-1	LowQuality
AGTCTTTGTCTAGGTT-1	LowQuality
AGTCTTTGTTCGTGAT-1	LowQuality
AGTCTTTGTTTCCACC-1	LowQuality
AGTCTTTTCCAAACTG-1	GoodQuality
AGTCTTTTCGGCGCAT-1	LowQuality
AGTCTTTTCTTTAGGG-1	LowQuality
AGTGAGGAGAGACGAA-1	GoodQuality
AGTGAGGAGCACACAG-1	LowQuality
AGTGAGGAGTGAATTG-1	LowQuality
AGTGAGGAGTTGTCGT-1	GoodQuality
AGTGAGGCAGCCAATT-1	LowQuality
AGTGAGGCAGGTGCCT-1	GoodQuality
AGTGAGGGTTCCACGG-1	GoodQuality
AGTGAGGTCAAACGGG-1	GoodQuality
AGTGAGGTCCTCAATT-1	GoodQuality
AGTGAGGTCTATCCTA-1	LowQuality
AGTGGGAAGCCACGCT-1	GoodQuality
AGTGGGAAGCCGGTAA-1	GoodQuality
AGTGGGAAGCTGTCTA-1	LowQuality
AGTGGGACATACAGCT-1	GoodQuality
AGTGGGACATATGGTC-1	GoodQuality
AGTGGGACATCCGGGT-1	LowQuality
AGTGGGACATCGGAAG-1	LowQuality
AGTGGGACATTAGGCT-1	GoodQuality
AGTGGGAGTAAGTGGC-1	GoodQuality
AGTGGGATCGTTTATC-1	GoodQuality
AGTGTCAAGACCGGAT-1	GoodQuality
AGTGTCAAGAGTTGGC-1	GoodQuality
AGTGTCAAGCCAGAAC-1	LowQuality
AGTGTCAAGGTGCACA-1	GoodQuality
AGTGTCAAGTCGTTTG-1	LowQuality
AGTGTCACAATAGCAA-1	GoodQuality
AGTGTCACACCATCCT-1	LowQuality
AGTGTCACAGAAGCAC-1	GoodQuality
AGTGTCACAGCCTGTG-1	GoodQuality
AGTGTCAGTAAGCACG-1	GoodQuality
AGTGTCAGTAGTAGTA-1	GoodQuality
AGTGTCAGTCGGCACT-1	GoodQuality
AGTGTCAGTTTAAGCC-1	GoodQuality
AGTGTCATCACCCGAG-1	GoodQuality
AGTGTCATCGAACTGT-1	GoodQuality
AGTGTCATCTAACCGA-1	LowQuality
AGTTGGTAGAGGTAGA-1	GoodQuality
AGTTGGTAGAGTAATC-1	LowQuality
AGTTGGTAGATCCGAG-1	LowQuality
AGTTGGTAGTACGATA-1	LowQuality
AGTTGGTAGTATTGGA-1	GoodQuality
AGTTGGTCACGGTGTC-1	GoodQuality
AGTTGGTCAGTCAGAG-1	LowQuality
AGTTGGTCAGTTTACG-1	GoodQuality
AGTTGGTCATCCCATC-1	LowQuality
AGTTGGTCATCGGGTC-1	GoodQuality
AGTTGGTGTACTCTCC-1	GoodQuality
AGTTGGTGTCACAAGG-1	LowQuality
AGTTGGTGTCTAGGTT-1	GoodQuality
AGTTGGTTCCCATTTA-1	GoodQuality
AGTTGGTTCTCATTCA-1	LowQuality
ATAACGCAGACGCAAC-1	GoodQuality
ATAACGCAGACGCTTT-1	LowQuality
ATAACGCAGATCTGAA-1	LowQuality
ATAACGCAGCCCTAAT-1	GoodQuality
ATAACGCAGGGTTCCC-1	GoodQuality
ATAACGCAGTGCCAGA-1	GoodQuality
ATAACGCCAATGAAAC-1	GoodQuality
ATAACGCCAGCTGTAT-1	GoodQuality
ATAACGCCATGCAATC-1	GoodQuality
ATAACGCGTAGGCATG-1	LowQuality
ATAACGCGTATGAATG-1	LowQuality
ATAACGCGTCGATTGT-1	GoodQuality
ATAACGCGTTGGGACA-1	LowQuality
ATAAGAGCAAATACAG-1	GoodQuality
ATAAGAGCACTGTGTA-1	GoodQuality
ATAAGAGCAGGAATCG-1	LowQuality
ATAAGAGCATAGTAAG-1	LowQuality
ATAAGAGGTCGAATCT-1	LowQuality
ATAAGAGGTTATGCGT-1	LowQuality
ATAAGAGGTTATGTGC-1	LowQuality
ATAAGAGGTTGCCTCT-1	LowQuality
ATAAGAGTCACCCTCA-1	GoodQuality
ATAAGAGTCCAGTAGT-1	GoodQuality
ATAAGAGTCTGACCTC-1	GoodQuality
ATAAGAGTCTTGTTTG-1	LowQuality
ATAGACCAGATACACA-1	LowQuality
ATAGACCAGATCGATA-1	LowQuality
ATAGACCAGCTAGTCT-1	LowQuality
ATAGACCAGCTGAACG-1	LowQuality
ATAGACCAGGAGTACC-1	LowQuality
ATAGACCAGGTGGGTT-1	LowQuality
ATAGACCAGTCACGCC-1	GoodQuality
ATAGACCAGTGGTAGC-1	GoodQuality
ATAGACCCAGTAACGG-1	GoodQuality
ATAGACCGTAGCGTCC-1	GoodQuality
ATAGACCGTGGTCTCG-1	LowQuality
ATAGACCGTTAAAGTG-1	GoodQuality
ATAGACCTCCTAGTGA-1	LowQuality
ATAGACCTCTTGAGAC-1	GoodQuality
ATCACGAAGAGCTGGT-1	GoodQuality
ATCACGAAGATACACA-1	GoodQuality
ATCACGAAGATGCCAG-1	LowQuality
ATCACGAAGATGGGTC-1	GoodQuality
ATCACGAAGTTACCCA-1	GoodQuality
ATCACGAAGTTGAGTA-1	GoodQuality
ATCACGACACATGTGT-1	GoodQuality
ATCACGACATGGTCAT-1	LowQuality
ATCACGAGTCCAACTA-1	GoodQuality
ATCACGAGTCCGTGAC-1	GoodQuality
ATCACGAGTCTCTTAT-1	GoodQuality
ATCACGAGTTGATTCG-1	GoodQuality
ATCACGATCACGCGGT-1	GoodQuality
ATCACGATCAGCAACT-1	LowQuality
ATCACGATCGGCTACG-1	GoodQuality
ATCACGATCGTATCAG-1	GoodQuality
ATCATCTAGAGTCTGG-1	LowQuality
ATCATCTCACCATGTA-1	GoodQuality
ATCATCTGTACAGTGG-1	GoodQuality
ATCATCTGTAGCGTAG-1	GoodQuality
ATCATCTGTAGGGACT-1	GoodQuality
ATCATCTGTATATGAG-1	GoodQuality
ATCATCTTCAATCACG-1	GoodQuality
ATCATCTTCCACGTTC-1	GoodQuality
ATCATGGAGAGAACAG-1	GoodQuality
ATCATGGAGAGTACCG-1	LowQuality
ATCATGGAGCACGCCT-1	LowQuality
ATCATGGAGGACCACA-1	GoodQuality
ATCATGGAGTCGCCGT-1	GoodQuality
ATCATGGAGTTTAGGA-1	LowQuality
ATCATGGCAGCTGCAC-1	GoodQuality
ATCATGGGTAAGCACG-1	LowQuality
ATCATGGGTGCGAAAC-1	GoodQuality
ATCATGGGTGGCGAAT-1	GoodQuality
ATCATGGGTTCATGGT-1	GoodQuality
ATCATGGGTTGGAGGT-1	GoodQuality
ATCATGGTCCAGAAGG-1	GoodQuality
ATCATGGTCCTTCAAT-1	GoodQuality
ATCATGGTCGCGGATC-1	LowQuality
ATCATGGTCTGGCGAC-1	GoodQuality
ATCCACCAGTACACCT-1	GoodQuality
ATCCACCCAATGAAAC-1	GoodQuality
ATCCACCCACAACGCC-1	LowQuality
ATCCACCCACCTCGTT-1	GoodQuality
ATCCACCCAGGGTATG-1	LowQuality
ATCCACCGTTCAGCGC-1	GoodQuality
ATCCACCTCCGCATAA-1	LowQuality
ATCCACCTCGCCGTGA-1	LowQuality
ATCCGAAAGCTACCTA-1	GoodQuality
ATCCGAAAGCTGCGAA-1	LowQuality
ATCCGAAAGGAACTGC-1	GoodQuality
ATCCGAAAGTTTGCGT-1	GoodQuality
ATCCGAACAATCAGAA-1	GoodQuality
ATCCGAACAGCGTAAG-1	GoodQuality
ATCCGAACAGGCAGTA-1	GoodQuality
ATCCGAACATCCCATC-1	GoodQuality
ATCCGAAGTACATCCA-1	LowQuality
ATCCGAAGTATATCCG-1	LowQuality
ATCCGAAGTGACCAAG-1	GoodQuality
ATCCGAAGTTAGATGA-1	LowQuality
ATCCGAATCAACACGT-1	GoodQuality
ATCCGAATCACATACG-1	GoodQuality
ATCCGAATCAGAAATG-1	GoodQuality
ATCCGAATCCGTACAA-1	GoodQuality
ATCCGAATCTGCTGCT-1	LowQuality
ATCGAGTAGGACAGCT-1	GoodQuality
ATCGAGTAGGTGCACA-1	LowQuality
ATCGAGTAGTGCGATG-1	GoodQuality
ATCGAGTCACAGACAG-1	GoodQuality
ATCGAGTGTAAGTAGT-1	LowQuality
ATCGAGTGTCTTGTCC-1	LowQuality
ATCGAGTTCGGCTTGG-1	GoodQuality
ATCGAGTTCTGCTGTC-1	GoodQuality
ATCTACTAGAAGAAGC-1	LowQuality
ATCTACTCACGGTGTC-1	GoodQuality
ATCTACTCAGGAACGT-1	GoodQuality
ATCTACTCATCCCACT-1	GoodQuality
ATCTACTCATGCGCAC-1	GoodQuality
ATCTACTGTACTTGAC-1	LowQuality
ATCTACTGTCAGCTAT-1	LowQuality
ATCTACTGTCGCGTGT-1	GoodQuality
ATCTACTGTCGGCTCA-1	LowQuality
ATCTACTGTTGATTCG-1	LowQuality
ATCTACTTCCATGCTC-1	LowQuality
ATCTACTTCCCTAATT-1	GoodQuality
ATCTGCCAGAGACTTA-1	GoodQuality
ATCTGCCAGGACCACA-1	LowQuality
ATCTGCCAGTGAAGAG-1	GoodQuality
ATCTGCCAGTTGAGTA-1	LowQuality
ATCTGCCCACGGACAA-1	GoodQuality
ATCTGCCCAGCTGTAT-1	LowQuality
ATCTGCCCATGCCTAA-1	LowQuality
ATCTGCCGTGCCTGCA-1	LowQuality
ATCTGCCGTTAGATGA-1	GoodQuality
ATCTGCCTCACAGTAC-1	LowQuality
ATCTGCCTCGTCCGTT-1	GoodQuality
ATCTGCCTCGTGGGAA-1	LowQuality
ATCTGCCTCTGCCAGG-1	GoodQuality
ATGAGGGAGCGATGAC-1	GoodQuality
ATGAGGGAGGCAAAGA-1	GoodQuality
ATGAGGGAGTGGTCCC-1	GoodQuality
ATGAGGGCAAGAAAGG-1	GoodQuality
ATGAGGGCACAGACTT-1	LowQuality
ATGAGGGCATATGCTG-1	GoodQuality
ATGAGGGCATTTCACT-1	GoodQuality
ATGAGGGGTAGGAGTC-1	GoodQuality
ATGAGGGGTCGCTTCT-1	GoodQuality
ATGAGGGGTCTAGAGG-1	LowQuality
ATGAGGGTCCACTGGG-1	GoodQuality
ATGAGGGTCCGTCATC-1	LowQuality
ATGAGGGTCGTGGGAA-1	LowQuality
ATGAGGGTCTTCGAGA-1	GoodQuality
ATGCGATAGCCAGGAT-1	GoodQuality
ATGCGATAGCGAAGGG-1	GoodQuality
ATGCGATAGGACTGGT-1	LowQuality
ATGCGATAGTCGAGTG-1	GoodQuality
ATGCGATAGTGACATA-1	LowQuality
ATGCGATCAAGTTGTC-1	GoodQuality
ATGCGATCACACCGAC-1	GoodQuality
ATGCGATGTGACTACT-1	GoodQuality
ATGCGATTCAAGATCC-1	GoodQuality
ATGCGATTCACGGTTA-1	GoodQuality
ATGGGAGAGAAGCCCA-1	LowQuality
ATGGGAGAGAGGGCTT-1	LowQuality
ATGGGAGAGATCGGGT-1	GoodQuality
ATGGGAGAGCCTTGAT-1	GoodQuality
ATGGGAGAGGAACTGC-1	GoodQuality
ATGGGAGAGTCCATAC-1	GoodQuality
ATGGGAGCAACTGCGC-1	GoodQuality
ATGGGAGCATTAGCCA-1	LowQuality
ATGGGAGGTACTTCTT-1	GoodQuality
ATGGGAGTCCGAATGT-1	LowQuality
ATGGGAGTCCGGGTGT-1	LowQuality
ATGGGAGTCCTACAGA-1	GoodQuality
ATGGGAGTCGGCGCAT-1	GoodQuality
ATGGGAGTCGGTTAAC-1	GoodQuality
ATGGGAGTCTGTCAAG-1	GoodQuality
ATGTGTGAGAAACGCC-1	LowQuality
ATGTGTGAGGCTAGGT-1	GoodQuality
ATGTGTGAGGTGTTAA-1	GoodQuality
ATGTGTGAGTACACCT-1	LowQuality
ATGTGTGAGTATGACA-1	GoodQuality
ATGTGTGAGTGGAGTC-1	GoodQuality
ATGTGTGCAGAGTGTG-1	GoodQuality
ATGTGTGGTCATGCAT-1	GoodQuality
ATGTGTGGTGTAATGA-1	GoodQuality
ATGTGTGGTTAAGTAG-1	GoodQuality
ATGTGTGGTTCAGACT-1	LowQuality
ATGTGTGTCGCATGGC-1	GoodQuality
ATTACTCAGCAGATCG-1	GoodQuality
ATTACTCAGCCGGTAA-1	LowQuality
ATTACTCAGCGTGAGT-1	GoodQuality
ATTACTCAGCTAACAA-1	LowQuality
ATTACTCAGCTACCTA-1	GoodQuality
ATTACTCCACCCATGG-1	GoodQuality
ATTACTCCATCCTAGA-1	GoodQuality
ATTACTCCATCGTCGG-1	GoodQuality
ATTACTCGTACGAAAT-1	GoodQuality
ATTACTCGTCATGCAT-1	GoodQuality
ATTACTCGTCGAAAGC-1	GoodQuality
ATTACTCGTCTCTTTA-1	LowQuality
ATTACTCGTGCAGTAG-1	LowQuality
ATTACTCGTGCTTCTC-1	GoodQuality
ATTACTCGTTATCGGT-1	GoodQuality
ATTACTCTCACAATGC-1	GoodQuality
ATTATCCAGGCAGTCA-1	GoodQuality
ATTATCCAGGCCCGTT-1	GoodQuality
ATTATCCCAAACCTAC-1	GoodQuality
ATTATCCCATGAACCT-1	GoodQuality
ATTATCCGTACCGTTA-1	GoodQuality
ATTATCCGTCCTCCAT-1	GoodQuality
ATTATCCTCCCTCTTT-1	GoodQuality
ATTATCCTCGGCGCTA-1	GoodQuality
ATTATCCTCTTGTACT-1	GoodQuality
ATTCTACAGATAGCAT-1	LowQuality
ATTCTACAGCAATATG-1	LowQuality
ATTCTACAGCGTTGCC-1	GoodQuality
ATTCTACCAGTGACAG-1	GoodQuality
ATTCTACCATCACAAC-1	LowQuality
ATTCTACCATCACGTA-1	GoodQuality
ATTCTACCATTACGAC-1	LowQuality
ATTCTACGTACCGAGA-1	GoodQuality
ATTCTACGTCAGTGGA-1	LowQuality
ATTCTACGTGTTCGAT-1	GoodQuality
ATTCTACTCCGGCACA-1	GoodQuality
ATTGGACAGAGACGAA-1	GoodQuality
ATTGGACAGATCGATA-1	GoodQuality
ATTGGACAGTAAGTAC-1	LowQuality
ATTGGACAGTCGATAA-1	LowQuality
ATTGGACAGTGAAGAG-1	LowQuality
ATTGGACCACCAGATT-1	GoodQuality
ATTGGACCAGACGCAA-1	GoodQuality
ATTGGACCATCCCACT-1	GoodQuality
ATTGGACCATTGGCGC-1	LowQuality
ATTGGACGTACTTAGC-1	GoodQuality
ATTGGACGTAGAAAGG-1	GoodQuality
ATTGGACGTAGCGTGA-1	LowQuality
ATTGGACGTGCCTGCA-1	GoodQuality
ATTGGACTCCAAAGTC-1	LowQuality
ATTGGTGAGCGCCTCA-1	LowQuality
ATTGGTGAGTTACCCA-1	LowQuality
ATTGGTGAGTTAGGTA-1	LowQuality
ATTGGTGCACAACTGT-1	GoodQuality
ATTGGTGCAGAGCCAA-1	GoodQuality
ATTGGTGCAGCTCCGA-1	GoodQuality
ATTGGTGCAGGAATCG-1	GoodQuality
ATTGGTGGTACAGCAG-1	GoodQuality
ATTGGTGGTATGAATG-1	GoodQuality
ATTGGTGGTGAGCGAT-1	GoodQuality
ATTGGTGGTTACGACT-1	GoodQuality
ATTGGTGGTTCGTGAT-1	GoodQuality
ATTGGTGGTTCTGAAC-1	GoodQuality
ATTGGTGGTTTCGCTC-1	GoodQuality
ATTGGTGTCCCATTAT-1	GoodQuality
ATTGGTGTCCCTGACT-1	GoodQuality
ATTGGTGTCCGCATAA-1	GoodQuality
ATTGGTGTCGTAGGAG-1	GoodQuality
ATTGGTGTCTCGCTTG-1	GoodQuality
ATTGGTGTCTGCGTAA-1	LowQuality
ATTTCTGAGCTCAACT-1	GoodQuality
ATTTCTGAGTGGGCTA-1	GoodQuality
ATTTCTGAGTTAGCGG-1	GoodQuality
ATTTCTGCAAGCCTAT-1	GoodQuality
ATTTCTGCAGGTCGTC-1	GoodQuality
ATTTCTGCATTCCTCG-1	GoodQuality
CAACCAAAGACAATAC-1	GoodQuality
CAACCAAAGGTGATTA-1	GoodQuality
CAACCAACAAATTGCC-1	LowQuality
CAACCAACAATACGCT-1	GoodQuality
CAACCAACACAACGCC-1	GoodQuality
CAACCAACATTTCACT-1	GoodQuality
CAACCAAGTATAGGGC-1	GoodQuality
CAACCAAGTATAGGTA-1	GoodQuality
CAACCAAGTCATGCAT-1	GoodQuality
CAACCAAGTCTAGCCG-1	LowQuality
CAACCAAGTCTCCACT-1	GoodQuality
CAACCAAGTGCGAAAC-1	LowQuality
CAACCAAGTTTGTTGG-1	GoodQuality
CAACCAATCCTCAACC-1	GoodQuality
CAACCAATCGAGGTAG-1	GoodQuality
CAACCTCAGACAGGCT-1	LowQuality
CAACCTCAGCCATCGC-1	LowQuality
CAACCTCAGGATATAC-1	LowQuality
CAACCTCAGGCATGTG-1	GoodQuality
CAACCTCAGGCTAGGT-1	GoodQuality
CAACCTCCACATCCAA-1	GoodQuality
CAACCTCCAGCCTTGG-1	LowQuality
CAACCTCCAGGGTATG-1	GoodQuality
CAACCTCCATCATCCC-1	LowQuality
CAACCTCCATCGATTG-1	GoodQuality
CAACCTCCATGTCGAT-1	GoodQuality
CAACCTCGTAAACACA-1	GoodQuality
CAACCTCGTAAGCACG-1	GoodQuality
CAACCTCGTAGAGGAA-1	LowQuality
CAACCTCGTCCGAATT-1	LowQuality
CAACCTCGTCGCATCG-1	LowQuality
CAACCTCGTCGGATCC-1	GoodQuality
CAACCTCGTGACCAAG-1	LowQuality
CAACCTCGTTTGGGCC-1	GoodQuality
CAACCTCTCCTAGAAC-1	LowQuality
CAACCTCTCGTGTAGT-1	GoodQuality
CAACCTCTCTTGACGA-1	LowQuality
CAACTAGAGAAACGAG-1	GoodQuality
CAACTAGAGAGGTACC-1	GoodQuality
CAACTAGAGCCCAATT-1	GoodQuality
CAACTAGAGTAGCCGA-1	GoodQuality
CAACTAGCAAAGCAAT-1	GoodQuality
CAACTAGCACCATGTA-1	LowQuality
CAACTAGCAGATTGCT-1	GoodQuality
CAACTAGCATTACCTT-1	GoodQuality
CAACTAGGTAATCGTC-1	GoodQuality
CAACTAGGTACAGACG-1	LowQuality
CAACTAGGTCATCGGC-1	GoodQuality
CAACTAGGTCGAGTTT-1	GoodQuality
CAACTAGGTGTCAATC-1	GoodQuality
CAACTAGGTTACGCGC-1	GoodQuality
CAACTAGTCCATTCTA-1	LowQuality
CAACTAGTCCGCGCAA-1	GoodQuality
CAACTAGTCCGTCAAA-1	GoodQuality
CAACTAGTCCTTTACA-1	GoodQuality
CAACTAGTCCTTTCGG-1	GoodQuality
CAAGAAAAGAAACCTA-1	LowQuality
CAAGAAAAGACTCGGA-1	GoodQuality
CAAGAAAAGCTTTGGT-1	LowQuality
CAAGAAAAGGCAATTA-1	LowQuality
CAAGAAAAGGGTTCCC-1	LowQuality
CAAGAAACATATGCTG-1	GoodQuality
CAAGAAACATGCTGGC-1	GoodQuality
CAAGAAAGTAGCCTCG-1	LowQuality
CAAGAAAGTAGGGACT-1	GoodQuality
CAAGAAAGTCTAGGTT-1	GoodQuality
CAAGAAATCACGCATA-1	GoodQuality
CAAGAAATCCAGTATG-1	GoodQuality
CAAGAAATCCGAGCCA-1	GoodQuality
CAAGAAATCGCAAACT-1	GoodQuality
CAAGAAATCTCACATT-1	GoodQuality
CAAGATCAGGTGGGTT-1	LowQuality
CAAGATCCACACAGAG-1	GoodQuality
CAAGATCCACGCCAGT-1	LowQuality
CAAGATCCAGAGCCAA-1	LowQuality
CAAGATCCAGCTCGCA-1	GoodQuality
CAAGATCCATGAAGTA-1	GoodQuality
CAAGATCCATTACCTT-1	GoodQuality
CAAGATCGTATAGTAG-1	GoodQuality
CAAGATCGTCAGATAA-1	GoodQuality
CAAGATCGTGTCCTCT-1	GoodQuality
CAAGATCGTTATCACG-1	GoodQuality
CAAGATCGTTTGCATG-1	GoodQuality
CAAGATCTCAGGATCT-1	GoodQuality
CAAGATCTCGGCGGTT-1	LowQuality
CAAGATCTCTCTAAGG-1	LowQuality
CAAGATCTCTGCAGTA-1	LowQuality
CAAGATCTCTTATCTG-1	LowQuality
CAAGGCCAGATAGGAG-1	GoodQuality
CAAGGCCAGCGAAGGG-1	LowQuality
CAAGGCCAGTTGTCGT-1	GoodQuality
CAAGGCCCAGCTGTGC-1	GoodQuality
CAAGGCCGTCCATGAT-1	LowQuality
CAAGGCCGTCCGAGTC-1	LowQuality
CAAGGCCGTCTCAACA-1	LowQuality
CAAGGCCTCCGTTGTC-1	GoodQuality
CAAGTTGAGAGGGCTT-1	LowQuality
CAAGTTGAGATCCTGT-1	GoodQuality
CAAGTTGAGTTAAGTG-1	GoodQuality
CAAGTTGCAATGGAAT-1	LowQuality
CAAGTTGCACAAGTAA-1	GoodQuality
CAAGTTGCAGCGTTCG-1	GoodQuality
CAAGTTGCATGCCTAA-1	GoodQuality
CAAGTTGGTAGCAAAT-1	GoodQuality
CAAGTTGGTCTAGAGG-1	GoodQuality
CAAGTTGTCACGACTA-1	GoodQuality
CAAGTTGTCCGTTGCT-1	GoodQuality
CACAAACAGACGCAAC-1	GoodQuality
CACAAACAGTGGGTTG-1	GoodQuality
CACAAACCACCAGATT-1	LowQuality
CACAAACCAGAGCCAA-1	GoodQuality
CACAAACGTGCAGACA-1	GoodQuality
CACAAACGTTACGCGC-1	GoodQuality
CACAAACGTTCCTCCA-1	LowQuality
CACAAACTCCGAATGT-1	LowQuality
CACAAACTCTGATTCT-1	GoodQuality
CACACAAAGACGACGT-1	GoodQuality
CACACAAAGTACATGA-1	LowQuality
CACACAAAGTTGTCGT-1	GoodQuality
CACACAACAACTGGCC-1	GoodQuality
CACACAACATTTGCCC-1	GoodQuality
CACACAAGTCATCGGC-1	GoodQuality
CACACAAGTCGATTGT-1	GoodQuality
CACACAATCATTATCC-1	GoodQuality
CACACCTAGATGTGGC-1	LowQuality
CACACCTAGGACACCA-1	GoodQuality
CACACCTAGTCAAGCG-1	LowQuality
CACACCTCAAACTGCT-1	GoodQuality
CACACCTCAAGCGTAG-1	GoodQuality
CACACCTCACAACTGT-1	GoodQuality
CACACCTCACAGGTTT-1	LowQuality
CACACCTCACCATGTA-1	GoodQuality
CACACCTCAGGGTATG-1	GoodQuality
CACACCTGTAGATTAG-1	GoodQuality
CACACCTGTGAGTGAC-1	LowQuality
CACACCTGTGCTGTAT-1	GoodQuality
CACACCTGTTCTGTTT-1	LowQuality
CACACCTTCTGAGGGA-1	GoodQuality
CACACTCAGCGATCCC-1	GoodQuality
CACACTCAGCTTCGCG-1	GoodQuality
CACACTCAGGCAGGTT-1	GoodQuality
CACACTCCAAAGAATC-1	GoodQuality
CACACTCCAAAGTGCG-1	GoodQuality
CACACTCCATTGTGCA-1	GoodQuality
CACACTCGTAACGACG-1	LowQuality
CACACTCGTAAGTTCC-1	LowQuality
CACACTCGTGACGGTA-1	GoodQuality
CACACTCGTGATGATA-1	LowQuality
CACACTCGTGCTGTAT-1	GoodQuality
CACACTCTCAGCCTAA-1	LowQuality
CACACTCTCAGGTTCA-1	GoodQuality
CACACTCTCCAAGTAC-1	GoodQuality
CACACTCTCTTCATGT-1	LowQuality
CACAGGCAGATGCCAG-1	GoodQuality
CACAGGCAGCTTCGCG-1	LowQuality
CACAGGCCAAAGGAAG-1	GoodQuality
CACAGGCCACAGGCCT-1	GoodQuality
CACAGGCCACGGTTTA-1	LowQuality
CACAGGCGTAGCGATG-1	GoodQuality
CACAGGCGTCTCAACA-1	GoodQuality
CACAGGCGTGACAAAT-1	GoodQuality
CACAGGCGTGCGAAAC-1	LowQuality
CACAGGCGTTACGGAG-1	GoodQuality
CACAGGCTCACGAAGG-1	GoodQuality
CACAGGCTCATCTGTT-1	GoodQuality
CACAGGCTCTCCCTGA-1	GoodQuality
CACAGGCTCTCTGAGA-1	GoodQuality
CACAGGCTCTGCAAGT-1	GoodQuality
CACAGTAAGGCAGGTT-1	GoodQuality
CACAGTACACTTACGA-1	GoodQuality
CACAGTACAGATCCAT-1	LowQuality
CACAGTACATTAACCG-1	GoodQuality
CACAGTAGTAAGGGAA-1	LowQuality
CACAGTATCACAGGCC-1	GoodQuality
CACAGTATCATCACCC-1	LowQuality
CACAGTATCGCCCTTA-1	LowQuality
CACAGTATCTAAGCCA-1	GoodQuality
CACAGTATCTCTGCTG-1	LowQuality
CACATAGAGACCTTTG-1	GoodQuality
CACATAGAGAGTACCG-1	GoodQuality
CACATAGAGGTGATTA-1	GoodQuality
CACATAGAGTAATCCC-1	GoodQuality
CACATAGCAAACAACA-1	GoodQuality
CACATAGCAAATCCGT-1	GoodQuality
CACATAGCACCCTATC-1	LowQuality
CACATAGCAGTGGGAT-1	GoodQuality
CACATAGGTTGATTCG-1	GoodQuality
CACATAGGTTTGTTTC-1	GoodQuality
CACATAGTCCAACCAA-1	LowQuality
CACATTTAGCGTTTAC-1	LowQuality
CACATTTAGGCTAGCA-1	LowQuality
CACATTTAGTAACCCT-1	LowQuality
CACATTTTCCACGTTC-1	GoodQuality
CACATTTTCCATGAGT-1	LowQuality
CACATTTTCGGGAGTA-1	LowQuality
CACATTTTCGTACGGC-1	LowQuality
CACATTTTCTGCTGCT-1	GoodQuality
CACATTTTCTTCGGTC-1	GoodQuality
CACCACTAGTCTCGGC-1	GoodQuality
CACCACTTCAGTCCCT-1	GoodQuality
CACCACTTCTGCTTGC-1	GoodQuality
CACCACTTCTTGCAAG-1	GoodQuality
CACCAGGAGCGCCTCA-1	LowQuality
CACCAGGAGCGTGAAC-1	GoodQuality
CACCAGGCAAAGGAAG-1	GoodQuality
CACCAGGCAAGCCTAT-1	LowQuality
CACCAGGCAAGTTGTC-1	GoodQuality
CACCAGGCAGTCAGCC-1	GoodQuality
CACCAGGCATCACGAT-1	GoodQuality
CACCAGGGTACTCAAC-1	LowQuality
CACCAGGGTACTCGCG-1	GoodQuality
CACCAGGGTTATCGGT-1	LowQuality
CACCAGGTCAATCACG-1	GoodQuality
CACCAGGTCGTGGTCG-1	GoodQuality
CACCTTGAGAAGGACA-1	GoodQuality
CACCTTGAGAGTGAGA-1	LowQuality
CACCTTGAGCTTCGCG-1	GoodQuality
CACCTTGAGGCCCGTT-1	GoodQuality
CACCTTGAGGGTTCCC-1	GoodQuality
CACCTTGAGTGATCGG-1	GoodQuality
CACCTTGCAAACTGTC-1	GoodQuality
CACCTTGCACTCGACG-1	GoodQuality
CACCTTGCATTCCTGC-1	LowQuality
CACCTTGGTAGAGGAA-1	LowQuality
CACCTTGGTGTGCGTC-1	LowQuality
CACCTTGGTTCACGGC-1	GoodQuality
CACCTTGGTTCTGGTA-1	LowQuality
CACCTTGGTTGTCGCG-1	GoodQuality
CACCTTGTCAATAAGG-1	LowQuality
CACCTTGTCCACTCCA-1	GoodQuality
CACCTTGTCGCTAGCG-1	LowQuality
CACCTTGTCTACTTAC-1	LowQuality
CACTCCACAAGTTGTC-1	GoodQuality
CACTCCACACACAGAG-1	GoodQuality
CACTCCACACGCCAGT-1	LowQuality
CACTCCACAGAAGCAC-1	GoodQuality
CACTCCAGTCGGCTCA-1	GoodQuality
CACTCCAGTTCCATGA-1	LowQuality
CACTCCATCAAGGTAA-1	GoodQuality
CACTCCATCGAATGGG-1	LowQuality
CAGAATCAGACTTTCG-1	LowQuality
CAGAATCAGCCAGTAG-1	GoodQuality
CAGAATCAGGCGTACA-1	LowQuality
CAGAATCCACCATCCT-1	GoodQuality
CAGAATCCAGTCAGCC-1	GoodQuality
CAGAATCGTTGGGACA-1	GoodQuality
CAGAATCTCAGGTTCA-1	GoodQuality
CAGAATCTCTCGCATC-1	GoodQuality
CAGAGAGAGCAACGGT-1	GoodQuality
CAGAGAGCAATAGCGG-1	GoodQuality
CAGAGAGCATTATCTC-1	GoodQuality
CAGAGAGGTACTCGCG-1	GoodQuality
CAGAGAGGTCCGAACC-1	LowQuality
CAGAGAGGTCTGATTG-1	GoodQuality
CAGAGAGGTTTGGCGC-1	GoodQuality
CAGAGAGTCCACGCAG-1	LowQuality
CAGAGAGTCTAACTCT-1	GoodQuality
CAGATCAAGCGAGAAA-1	LowQuality
CAGATCAAGGCCCTTG-1	GoodQuality
CAGATCAAGTGGGCTA-1	GoodQuality
CAGATCAAGTTCGCAT-1	GoodQuality
CAGATCACAAGCCATT-1	LowQuality
CAGATCACAATTGCTG-1	GoodQuality
CAGATCACACAGACTT-1	GoodQuality
CAGATCACATTCTTAC-1	LowQuality
CAGATCATCAACGGGA-1	GoodQuality
CAGATCATCACCACCT-1	GoodQuality
CAGATCATCACGCGGT-1	GoodQuality
CAGATCATCCACTCCA-1	GoodQuality
CAGATCATCTCGTATT-1	GoodQuality
CAGCAGCAGAGATGAG-1	LowQuality
CAGCAGCAGGACTGGT-1	LowQuality
CAGCAGCCAAGCCATT-1	LowQuality
CAGCAGCCAATCCAAC-1	LowQuality
CAGCAGCCACCACGTG-1	GoodQuality
CAGCAGCCAGCCTTGG-1	LowQuality
CAGCAGCGTAAAGGAG-1	GoodQuality
CAGCAGCGTACGAAAT-1	GoodQuality
CAGCAGCGTACGACCC-1	LowQuality
CAGCAGCGTCAACTGT-1	GoodQuality
CAGCAGCGTCTAACGT-1	GoodQuality
CAGCAGCGTCTAGGTT-1	GoodQuality
CAGCAGCGTTTCGCTC-1	GoodQuality
CAGCATAAGGAGTACC-1	GoodQuality
CAGCATAAGTCTCCTC-1	GoodQuality
CAGCATACACACAGAG-1	GoodQuality
CAGCATACACCGCTAG-1	LowQuality
CAGCATACACGCGAAA-1	GoodQuality
CAGCATACACGCTTTC-1	GoodQuality
CAGCATAGTCTTGTCC-1	GoodQuality
CAGCATAGTTCGTTGA-1	GoodQuality
CAGCATAGTTTGACAC-1	GoodQuality
CAGCATATCAGCGACC-1	LowQuality
CAGCATATCAGTACGT-1	GoodQuality
CAGCATATCCTCAACC-1	GoodQuality
CAGCATATCGCAAGCC-1	GoodQuality
CAGCATATCTTCAACT-1	GoodQuality
CAGCCGAAGATGTGGC-1	GoodQuality
CAGCCGAAGCACCGTC-1	GoodQuality
CAGCCGAAGCGTGAAC-1	GoodQuality
CAGCCGAAGCTAGCCC-1	LowQuality
CAGCCGAAGGACATTA-1	LowQuality
CAGCCGACAAGCCCAC-1	GoodQuality
CAGCCGACACTTAACG-1	GoodQuality
CAGCCGACAGCATGAG-1	GoodQuality
CAGCCGACAGCCTGTG-1	LowQuality
CAGCCGACATTGCGGC-1	LowQuality
CAGCCGAGTAAGTGGC-1	GoodQuality
CAGCCGAGTGATAAGT-1	LowQuality
CAGCCGAGTGCATCTA-1	GoodQuality
CAGCCGAGTTAAGACA-1	LowQuality
CAGCCGAGTTATCCGA-1	GoodQuality
CAGCCGATCGTGGGAA-1	GoodQuality
CAGCGACAGAGCTTCT-1	GoodQuality
CAGCGACAGTTGAGAT-1	GoodQuality
CAGCGACCAATCCAAC-1	LowQuality
CAGCGACCATTTCACT-1	GoodQuality
CAGCGACCATTTCAGG-1	GoodQuality
CAGCGACGTCATCGGC-1	GoodQuality
CAGCGACGTGGCGAAT-1	GoodQuality
CAGCGACGTTACAGAA-1	GoodQuality
CAGCGACTCCGCATCT-1	GoodQuality
CAGCGACTCTGGTTCC-1	GoodQuality
CAGCGACTCTTACCGC-1	LowQuality
CAGCTAACACATGGGA-1	GoodQuality
CAGCTAACACTTACGA-1	GoodQuality
CAGCTAACAGTCTTCC-1	LowQuality
CAGCTAAGTACCAGTT-1	LowQuality
CAGCTAAGTAGAGCTG-1	LowQuality
CAGCTAAGTAGATTAG-1	GoodQuality
CAGCTAAGTAGCACGA-1	LowQuality
CAGCTAAGTCATGCCG-1	GoodQuality
CAGCTAAGTTTCGCTC-1	GoodQuality
CAGCTAATCAAGGTAA-1	GoodQuality
CAGCTAATCCTCAATT-1	LowQuality
CAGCTGGAGGATGGTC-1	GoodQuality
CAGCTGGAGTGAACGC-1	GoodQuality
CAGCTGGAGTGAATTG-1	GoodQuality
CAGCTGGCAAGAGTCG-1	GoodQuality
CAGCTGGCACATGGGA-1	GoodQuality
CAGCTGGCACTAGTAC-1	LowQuality
CAGCTGGCAGCGAACA-1	LowQuality
CAGCTGGGTGATGTGG-1	GoodQuality
CAGCTGGGTTCAACCA-1	LowQuality
CAGCTGGTCAGCTTAG-1	GoodQuality
CAGCTGGTCCAATGGT-1	LowQuality
CAGCTGGTCCTTGGTC-1	LowQuality
CAGCTGGTCGACGGAA-1	LowQuality
CAGGTGCAGCGTTGCC-1	GoodQuality
CAGGTGCCAACACCTA-1	GoodQuality
CAGGTGCCACTTAACG-1	GoodQuality
CAGGTGCCATCATCCC-1	LowQuality
CAGGTGCGTAAATACG-1	GoodQuality
CAGGTGCGTACATCCA-1	GoodQuality
CAGGTGCGTAGAAAGG-1	GoodQuality
CAGGTGCGTCTTGTCC-1	LowQuality
CAGGTGCGTGCAGGTA-1	GoodQuality
CAGGTGCGTGTAAGTA-1	LowQuality
CAGGTGCGTTCCACAA-1	GoodQuality
CAGGTGCTCGGTTCGG-1	GoodQuality
CAGGTGCTCTCACATT-1	LowQuality
CAGGTGCTCTGCCCTA-1	GoodQuality
CAGTAACAGCTCCTTC-1	LowQuality
CAGTAACAGGATGGTC-1	GoodQuality
CAGTAACAGTGAATTG-1	LowQuality
CAGTAACCACCGAATT-1	GoodQuality
CAGTAACCACGAAAGC-1	GoodQuality
CAGTAACGTCGCATAT-1	GoodQuality
CAGTAACGTTGTGGAG-1	GoodQuality
CAGTAACTCGCTGATA-1	GoodQuality
CAGTAACTCGGTCTAA-1	LowQuality
CAGTCCTAGCCCTAAT-1	GoodQuality
CAGTCCTAGCTAGTCT-1	GoodQuality
CAGTCCTAGGGTTTCT-1	LowQuality
CAGTCCTAGTAACCCT-1	GoodQuality
CAGTCCTAGTGGGTTG-1	LowQuality
CAGTCCTCAACCGCCA-1	LowQuality
CAGTCCTCAAGCGTAG-1	LowQuality
CAGTCCTCACATCCAA-1	GoodQuality
CAGTCCTCACGAAAGC-1	GoodQuality
CAGTCCTCAGAAGCAC-1	GoodQuality
CAGTCCTGTCCATCCT-1	GoodQuality
CAGTCCTGTTCACGGC-1	GoodQuality
CAGTCCTGTTGATTCG-1	LowQuality
CAGTCCTTCCAGAGGA-1	GoodQuality
CAGTCCTTCCAGTAGT-1	GoodQuality
CATATGGAGCACCGCT-1	GoodQuality
CATATGGAGGCAAAGA-1	LowQuality
CATATGGAGTCATGCT-1	GoodQuality
CATATGGCAAGGACTG-1	GoodQuality
CATATGGCATCCCACT-1	GoodQuality
CATATGGGTCATGCCG-1	GoodQuality
CATATGGGTCGTCTTC-1	GoodQuality
CATATGGTCCCATTAT-1	GoodQuality
CATATTCAGACTAGAT-1	LowQuality
CATATTCCAAGGGTCA-1	GoodQuality
CATATTCCACCACCAG-1	GoodQuality
CATATTCCACCCATTC-1	GoodQuality
CATATTCGTCGCATAT-1	LowQuality
CATATTCGTCGGGTCT-1	LowQuality
CATATTCGTGCAACGA-1	GoodQuality
CATATTCGTGCCTGCA-1	LowQuality
CATATTCGTTCAACCA-1	GoodQuality
CATATTCTCCTACAGA-1	GoodQuality
CATCAAGAGGCATGTG-1	GoodQuality
CATCAAGCAAGAAAGG-1	GoodQuality
CATCAAGCATGAGCGA-1	LowQuality
CATCAAGCATGGTCTA-1	GoodQuality
CATCAAGCATGTCTCC-1	GoodQuality
CATCAAGCATTTGCTT-1	GoodQuality
CATCAAGGTAACGCGA-1	GoodQuality
CATCAAGGTTACGGAG-1	LowQuality
CATCAAGGTTGAGGTG-1	GoodQuality
CATCAAGTCGAACTGT-1	GoodQuality
CATCAAGTCTATCGCC-1	GoodQuality
CATCAAGTCTTCCTTC-1	GoodQuality
CATCAGAAGCAATATG-1	GoodQuality
CATCAGAAGGGTCGAT-1	GoodQuality
CATCAGAAGTCAATAG-1	LowQuality
CATCAGAAGTGGAGAA-1	GoodQuality
CATCAGAAGTGTTGAA-1	LowQuality
CATCAGACAACGCACC-1	GoodQuality
CATCAGACACACATGT-1	LowQuality
CATCAGACACATCTTT-1	LowQuality
CATCAGACACCACCAG-1	LowQuality
CATCAGACACTGTTAG-1	GoodQuality
CATCAGACAGAGTGTG-1	GoodQuality
CATCAGACAGCCTGTG-1	GoodQuality
CATCAGACAGCTATTG-1	GoodQuality
CATCAGACATCACAAC-1	LowQuality
CATCAGAGTCCGCTGA-1	GoodQuality
CATCAGAGTTAGAACA-1	GoodQuality
CATCAGAGTTCCACGG-1	GoodQuality
CATCAGAGTTCCATGA-1	GoodQuality
CATCAGATCAACCATG-1	GoodQuality
CATCAGATCATCTGTT-1	GoodQuality
CATCAGATCCAACCAA-1	GoodQuality
CATCAGATCCGCAAGC-1	GoodQuality
CATCAGATCGAGAGCA-1	GoodQuality
CATCAGATCGGCCGAT-1	LowQuality
CATCAGATCGGCGCAT-1	GoodQuality
CATCAGATCGTCTGCT-1	GoodQuality
CATCAGATCTGACCTC-1	GoodQuality
CATCCACAGAATTCCC-1	GoodQuality
CATCCACAGCATCATC-1	GoodQuality
CATCCACAGCTCCTTC-1	GoodQuality
CATCCACCAAGTAGTA-1	LowQuality
CATCCACCACCCATGG-1	GoodQuality
CATCCACGTCTAGGTT-1	GoodQuality
CATCCACTCCCGGATG-1	GoodQuality
CATCCACTCGTGGGAA-1	GoodQuality
CATCCACTCTGGTGTA-1	LowQuality
CATCGAAAGACTGTAA-1	GoodQuality
CATCGAAAGATCGGGT-1	GoodQuality
CATCGAACACTTACGA-1	GoodQuality
CATCGAACAGATCGGA-1	GoodQuality
CATCGAACAGCCTGTG-1	GoodQuality
CATCGAAGTAGATTAG-1	GoodQuality
CATCGAAGTCGCATCG-1	GoodQuality
CATCGAAGTTCTGAAC-1	GoodQuality
CATCGAATCAGCTGGC-1	GoodQuality
CATCGAATCCGCGGTA-1	GoodQuality
CATCGAATCCTCGCAT-1	LowQuality
CATCGAATCGCGGATC-1	GoodQuality
CATCGAATCGTGGTCG-1	LowQuality
CATCGAATCTAGCACA-1	GoodQuality
CATCGAATCTTCTGGC-1	LowQuality
CATCGGGAGGGTGTGT-1	GoodQuality
CATCGGGAGTGGACGT-1	GoodQuality
CATCGGGAGTTGTCGT-1	LowQuality
CATCGGGCAAGAGGCT-1	LowQuality
CATCGGGCACGACTCG-1	LowQuality
CATCGGGCAGGGAGAG-1	LowQuality
CATCGGGCATTAACCG-1	GoodQuality
CATCGGGGTCAAAGCG-1	GoodQuality
CATCGGGGTCCAGTAT-1	GoodQuality
CATCGGGGTGTCTGAT-1	GoodQuality
CATCGGGGTTGGAGGT-1	GoodQuality
CATCGGGTCAAACGGG-1	LowQuality
CATCGGGTCAATAAGG-1	GoodQuality
CATCGGGTCAGGCCCA-1	GoodQuality
CATCGGGTCAGTTGAC-1	GoodQuality
CATGACAAGATGCCTT-1	GoodQuality
CATGACAAGGTGATTA-1	LowQuality
CATGACAAGTCAAGCG-1	GoodQuality
CATGACAGTAAAGTCA-1	LowQuality
CATGACAGTTCCCGAG-1	GoodQuality
CATGACATCATCTGTT-1	GoodQuality
CATGACATCGTGGACC-1	GoodQuality
CATGACATCTCGTATT-1	GoodQuality
CATGCCTAGAAGAAGC-1	GoodQuality
CATGCCTAGGTGGGTT-1	GoodQuality
CATGCCTAGTGTACTC-1	GoodQuality
CATGCCTAGTGTGAAT-1	LowQuality
CATGCCTCAACTGCGC-1	LowQuality
CATGCCTGTACACCGC-1	GoodQuality
CATGCCTGTCTTGCGG-1	GoodQuality
CATGCCTGTGCACCAC-1	GoodQuality
CATGCCTTCCCTAATT-1	GoodQuality
CATGCCTTCGTCTGCT-1	GoodQuality
CATGCCTTCTACCAGA-1	GoodQuality
CATGCCTTCTGCGTAA-1	GoodQuality
CATGGCGAGCTTCGCG-1	GoodQuality
CATGGCGAGTCATCCA-1	GoodQuality
CATGGCGGTTAGAACA-1	GoodQuality
CATGGCGTCAAACCGT-1	GoodQuality
CATGGCGTCACGGTTA-1	LowQuality
CATGGCGTCGGAATCT-1	LowQuality
CATGGCGTCTCCAGGG-1	GoodQuality
CATGGCGTCTTGTCAT-1	LowQuality
CATTATCAGCGATATA-1	GoodQuality
CATTATCAGGTAAACT-1	LowQuality
CATTATCCAAGGGTCA-1	LowQuality
CATTATCCAATCAGAA-1	GoodQuality
CATTATCGTCACCCAG-1	LowQuality
CATTATCGTTTGTTGG-1	LowQuality
CATTATCTCGCCATAA-1	GoodQuality
CATTATCTCTCAACTT-1	LowQuality
CATTCGCAGACCGGAT-1	GoodQuality
CATTCGCAGGGTCGAT-1	LowQuality
CATTCGCAGGTGGGTT-1	GoodQuality
CATTCGCAGTGAATTG-1	GoodQuality
CATTCGCCAAGGACTG-1	GoodQuality
CATTCGCCACCCATGG-1	LowQuality
CATTCGCCAGCCAATT-1	GoodQuality
CATTCGCGTTCTCATT-1	GoodQuality
CATTCGCTCCGCATAA-1	LowQuality
CATTCGCTCCGCATCT-1	GoodQuality
CATTCGCTCCGCGCAA-1	LowQuality
CATTCGCTCGGAGGTA-1	LowQuality
CCAATCCAGAATGTTG-1	GoodQuality
CCAATCCAGACCCACC-1	GoodQuality
CCAATCCCAGGAATCG-1	GoodQuality
CCAATCCCAGGACGTA-1	LowQuality
CCAATCCCATACTACG-1	GoodQuality
CCAATCCTCAAGGTAA-1	LowQuality
CCAATCCTCATGTCTT-1	GoodQuality
CCAATCCTCCAAACTG-1	GoodQuality
CCAATCCTCTGTCCGT-1	GoodQuality
CCACCTAAGACGCAAC-1	GoodQuality
CCACCTAAGACTAAGT-1	GoodQuality
CCACCTAAGTCCTCCT-1	GoodQuality
CCACCTACAATAAGCA-1	GoodQuality
CCACCTACAATAGAGT-1	GoodQuality
CCACCTACACCAGATT-1	GoodQuality
CCACCTACACGGCCAT-1	LowQuality
CCACCTACATCCTAGA-1	GoodQuality
CCACCTACATTCACTT-1	LowQuality
CCACCTAGTATGAATG-1	LowQuality
CCACCTAGTCTTGTCC-1	GoodQuality
CCACCTAGTTGTCGCG-1	LowQuality
CCACCTATCAACACAC-1	GoodQuality
CCACCTATCCACTCCA-1	LowQuality
CCACCTATCGGCTACG-1	GoodQuality
CCACCTATCTAACGGT-1	LowQuality
CCACGGAAGAAGGTGA-1	GoodQuality
CCACGGAAGTCTTGCA-1	GoodQuality
CCACGGAAGTGTGAAT-1	GoodQuality
CCACGGACAAGCGATG-1	GoodQuality
CCACGGACACGTAAGG-1	GoodQuality
CCACGGACATCCCATC-1	GoodQuality
CCACGGACATCTATGG-1	GoodQuality
CCACGGAGTACGCACC-1	GoodQuality
CCACGGAGTCGAGATG-1	LowQuality
CCACGGAGTGTTTGTG-1	GoodQuality
CCACGGAGTTGATTCG-1	GoodQuality
CCACGGAGTTTAGGAA-1	GoodQuality
CCACGGATCTACCTGC-1	LowQuality
CCACTACAGGTGCAAC-1	GoodQuality
CCACTACAGTAGGCCA-1	GoodQuality
CCACTACCAAGAGGCT-1	GoodQuality
CCACTACCATTTGCTT-1	GoodQuality
CCACTACGTAGAGGAA-1	LowQuality
CCACTACGTCTTTCAT-1	GoodQuality
CCACTACGTGACTACT-1	LowQuality
CCACTACGTTCGTCTC-1	LowQuality
CCACTACTCAAACCAC-1	GoodQuality
CCACTACTCAACACTG-1	GoodQuality
CCACTACTCAGGTTCA-1	GoodQuality
CCAGCGAAGAAGGTGA-1	GoodQuality
CCAGCGAAGGTGATTA-1	GoodQuality
CCAGCGAAGGTGCAAC-1	GoodQuality
CCAGCGAAGTTCGCAT-1	GoodQuality
CCAGCGAAGTTTCCTT-1	GoodQuality
CCAGCGAGTAAACCTC-1	GoodQuality
CCAGCGAGTAGGCATG-1	LowQuality
CCAGCGAGTAGTAGTA-1	LowQuality
CCAGCGAGTCTACCTC-1	GoodQuality
CCAGCGAGTTCAGGCC-1	GoodQuality
CCAGCGAGTTCCAACA-1	GoodQuality
CCAGCGATCCAACCAA-1	LowQuality
CCAGCGATCCCTTGTG-1	GoodQuality
CCAGCGATCGGAAACG-1	LowQuality
CCAGCGATCTAACTTC-1	LowQuality
CCATGTCAGGGTTTCT-1	GoodQuality
CCATGTCAGTCTCAAC-1	GoodQuality
CCATGTCAGTTATCGC-1	LowQuality
CCATGTCCAACTGGCC-1	LowQuality
CCATGTCCACATGGGA-1	GoodQuality
CCATGTCCACGGTAAG-1	LowQuality
CCATGTCCACGGTAGA-1	GoodQuality
CCATGTCCATGCTAGT-1	GoodQuality
CCATGTCGTCCATGAT-1	GoodQuality
CCATGTCTCCAACCAA-1	GoodQuality
CCATGTCTCCTGCCAT-1	GoodQuality
CCATGTCTCGGATGGA-1	GoodQuality
CCATGTCTCGTACCGG-1	LowQuality
CCATGTCTCTACGAGT-1	LowQuality
CCATTCGAGACTTGAA-1	GoodQuality
CCATTCGAGAGTCTGG-1	GoodQuality
CCATTCGAGATGGCGT-1	GoodQuality
CCATTCGAGCTGAAAT-1	GoodQuality
CCATTCGCATCGATTG-1	GoodQuality
CCATTCGCATGCTGGC-1	LowQuality
CCATTCGGTATCAGTC-1	GoodQuality
CCATTCGGTCGAGATG-1	GoodQuality
CCATTCGGTCGCGAAA-1	GoodQuality
CCATTCGGTCTAGTCA-1	GoodQuality
CCATTCGTCCCTGACT-1	LowQuality
CCATTCGTCCGTAGTA-1	GoodQuality
CCATTCGTCGCCTGAG-1	GoodQuality
CCATTCGTCTCGATGA-1	LowQuality
CCCAATCAGTAGATGT-1	GoodQuality
CCCAATCAGTTGTAGA-1	GoodQuality
CCCAATCCAAGCGCTC-1	LowQuality
CCCAATCCAATGGATA-1	GoodQuality
CCCAATCCACGTCTCT-1	GoodQuality
CCCAATCCAGGCAGTA-1	LowQuality
CCCAATCCATTTCACT-1	LowQuality
CCCAATCGTGCAGACA-1	GoodQuality
CCCAATCGTTCAGGCC-1	GoodQuality
CCCAATCTCTCGATGA-1	GoodQuality
CCCAATCTCTTGGGTA-1	LowQuality
CCCAGTTAGCATGGCA-1	GoodQuality
CCCAGTTAGCCTTGAT-1	GoodQuality
CCCAGTTAGTAGATGT-1	LowQuality
CCCAGTTAGTATGACA-1	GoodQuality
CCCAGTTAGTCCGTAT-1	GoodQuality
CCCAGTTCAATGTAAG-1	GoodQuality
CCCAGTTCACCCATTC-1	LowQuality
CCCAGTTCAGACAAAT-1	GoodQuality
CCCAGTTCATCTGGTA-1	GoodQuality
CCCAGTTGTAGAGCTG-1	GoodQuality
CCCAGTTGTGACTACT-1	GoodQuality
CCCAGTTGTTCAGACT-1	LowQuality
CCCAGTTTCACGCGGT-1	LowQuality
CCCAGTTTCCGTAGTA-1	LowQuality
CCCATACAGCTGCAAG-1	GoodQuality
CCCATACAGCTGGAAC-1	GoodQuality
CCCATACAGGGTTTCT-1	LowQuality
CCCATACAGTGGGTTG-1	LowQuality
CCCATACCAGTAACGG-1	LowQuality
CCCATACCAGTGGAGT-1	GoodQuality
CCCATACCATCACGAT-1	LowQuality
CCCATACGTAAGTGTA-1	GoodQuality
CCCATACGTCATTAGC-1	GoodQuality
CCCATACGTCCGCTGA-1	LowQuality
CCCATACGTCTCATCC-1	GoodQuality
CCCATACGTCTTGTCC-1	GoodQuality
CCCATACGTGGGTCAA-1	GoodQuality
CCCATACGTTGGGACA-1	LowQuality
CCCATACGTTTGCATG-1	GoodQuality
CCCATACTCCCAGGTG-1	GoodQuality
CCCATACTCCTGTAGA-1	GoodQuality
CCCATACTCGAGCCCA-1	GoodQuality
CCCATACTCGCCCTTA-1	GoodQuality
CCCTCCTAGTATCGAA-1	LowQuality
CCCTCCTAGTGGAGAA-1	GoodQuality
CCCTCCTCAATAGAGT-1	GoodQuality
CCCTCCTCATGGGACA-1	GoodQuality
CCCTCCTGTAGTGAAT-1	LowQuality
CCCTCCTGTCAAGCGA-1	GoodQuality
CCCTCCTGTCCAGTGC-1	GoodQuality
CCCTCCTGTCCATGAT-1	GoodQuality
CCCTCCTGTGCCTGTG-1	LowQuality
CCCTCCTGTTCCTCCA-1	GoodQuality
CCCTCCTGTTCGAATC-1	GoodQuality
CCCTCCTTCATTTGGG-1	GoodQuality
CCCTCCTTCCTTGCCA-1	LowQuality
CCCTCCTTCGTTACGA-1	GoodQuality
CCCTCCTTCTTTACAC-1	GoodQuality
CCGGGATCAAGAGTCG-1	LowQuality
CCGGGATCAAGGACTG-1	GoodQuality
CCGGGATCAATGGACG-1	LowQuality
CCGGGATCACCTCGTT-1	GoodQuality
CCGGGATCATAAAGGT-1	GoodQuality
CCGGGATGTCCAGTAT-1	GoodQuality
CCGGGATGTCGCTTTC-1	LowQuality
CCGGTAGAGACTCGGA-1	GoodQuality
CCGGTAGAGCTGGAAC-1	GoodQuality
CCGGTAGAGTACGCGA-1	LowQuality
CCGGTAGAGTGGTAAT-1	GoodQuality
CCGGTAGCAGCTTCGG-1	GoodQuality
CCGGTAGCAGTAGAGC-1	GoodQuality
CCGGTAGCATCGTCGG-1	GoodQuality
CCGGTAGCATGAGCGA-1	LowQuality
CCGGTAGCATGTCTCC-1	LowQuality
CCGGTAGGTAGCGCTC-1	GoodQuality
CCGGTAGGTCGGCATC-1	LowQuality
CCGGTAGGTCTCTCTG-1	GoodQuality
CCGGTAGTCAATAAGG-1	GoodQuality
CCGGTAGTCGAATGGG-1	GoodQuality
CCGGTAGTCTCACATT-1	GoodQuality
CCGGTAGTCTTTACAC-1	GoodQuality
CCGTACTAGATGGCGT-1	GoodQuality
CCGTACTAGCGCTTAT-1	LowQuality
CCGTACTCAGTATCTG-1	GoodQuality
CCGTACTCATGTCGAT-1	GoodQuality
CCGTACTGTATCACCA-1	GoodQuality
CCGTACTGTATGGTTC-1	GoodQuality
CCGTACTGTCTAAACC-1	GoodQuality
CCGTACTGTCTGCCAG-1	GoodQuality
CCGTACTTCAAACCAC-1	GoodQuality
CCGTACTTCATTGCCC-1	LowQuality
CCGTACTTCCCTCTTT-1	GoodQuality
CCGTACTTCCGTAGTA-1	GoodQuality
CCGTACTTCTATCGCC-1	GoodQuality
CCGTACTTCTGTCAAG-1	LowQuality
CCGTACTTCTTGAGAC-1	GoodQuality
CCGTACTTCTTTACGT-1	GoodQuality
CCGTGGAAGGATTCGG-1	GoodQuality
CCGTGGAAGGCGATAC-1	LowQuality
CCGTGGAAGTACCGGA-1	GoodQuality
CCGTGGAAGTTTCCTT-1	GoodQuality
CCGTGGAGTGCAACGA-1	GoodQuality
CCGTGGAGTGCTTCTC-1	GoodQuality
CCGTGGAGTTACCAGT-1	GoodQuality
CCGTGGATCAACTCTT-1	LowQuality
CCGTGGATCCGAACGC-1	GoodQuality
CCGTGGATCCTAGGGC-1	GoodQuality
CCGTGGATCGCTAGCG-1	LowQuality
CCGTTCAAGAGGTTAT-1	GoodQuality
CCGTTCAAGATCGATA-1	GoodQuality
CCGTTCAAGCGGATCA-1	LowQuality
CCGTTCAAGCTCTCGG-1	GoodQuality
CCGTTCAAGGCCATAG-1	GoodQuality
CCGTTCAAGTACGTAA-1	GoodQuality
CCGTTCAAGTCTCGGC-1	LowQuality
CCGTTCAAGTTACGGG-1	GoodQuality
CCGTTCACAAGTACCT-1	LowQuality
CCGTTCACAATCAGAA-1	GoodQuality
CCGTTCACATACCATG-1	GoodQuality
CCGTTCACATGACGGA-1	GoodQuality
CCGTTCACATTCCTGC-1	GoodQuality
CCGTTCAGTGACGCCT-1	LowQuality
CCGTTCAGTGCACCAC-1	GoodQuality
CCGTTCAGTGTGAAAT-1	GoodQuality
CCGTTCATCACCTTAT-1	GoodQuality
CCGTTCATCCACGAAT-1	GoodQuality
CCGTTCATCGGAAATA-1	GoodQuality
CCGTTCATCGTCACGG-1	GoodQuality
CCGTTCATCTGGTGTA-1	GoodQuality
CCGTTCATCTTTACGT-1	GoodQuality
CCTAAAGAGAGACGAA-1	LowQuality
CCTAAAGAGCGTGTCC-1	LowQuality
CCTAAAGAGGCCCTCA-1	LowQuality
CCTAAAGAGGGTGTGT-1	LowQuality
CCTAAAGAGGTGATTA-1	LowQuality
CCTAAAGAGTACTTGC-1	GoodQuality
CCTAAAGAGTATGACA-1	LowQuality
CCTAAAGCACACTGCG-1	LowQuality
CCTAAAGCATCCCACT-1	LowQuality
CCTAAAGGTACGCACC-1	GoodQuality
CCTAAAGGTATAAACG-1	LowQuality
CCTAAAGGTCTTTCAT-1	GoodQuality
CCTAAAGGTTCAGACT-1	LowQuality
CCTAAAGTCTGCTGTC-1	LowQuality
CCTACACAGCAGGTCA-1	LowQuality
CCTACACAGGGTCGAT-1	GoodQuality
CCTACACAGTGCCATT-1	GoodQuality
CCTACACCAAAGTCAA-1	GoodQuality
CCTACACCAATAGCAA-1	GoodQuality
CCTACACGTCAAGCGA-1	GoodQuality
CCTACACGTCATGCAT-1	GoodQuality
CCTACACGTGTTTGTG-1	LowQuality
CCTACACTCACTTATC-1	GoodQuality
CCTACACTCATCGCTC-1	GoodQuality
CCTACACTCTGAGGGA-1	GoodQuality
CCTACCAAGGCATGGT-1	GoodQuality
CCTACCACAAGCCCAC-1	LowQuality
CCTACCACACATGTGT-1	LowQuality
CCTACCACAGACAGGT-1	GoodQuality
CCTACCACATGCCCGA-1	GoodQuality
CCTACCAGTAGTAGTA-1	GoodQuality
CCTACCAGTCTCCACT-1	GoodQuality
CCTACCAGTGTCGCTG-1	GoodQuality
CCTACCAGTGTGGTTT-1	GoodQuality
CCTACCAGTTGCCTCT-1	LowQuality
CCTACCATCAGCTCTC-1	GoodQuality
CCTACCATCTGAAAGA-1	GoodQuality
CCTAGCTAGATACACA-1	GoodQuality
CCTAGCTAGGAGTCTG-1	GoodQuality
CCTAGCTAGTCATGCT-1	GoodQuality
CCTAGCTCACACCGCA-1	GoodQuality
CCTAGCTCACAGAGGT-1	GoodQuality
CCTAGCTCATAGACTC-1	GoodQuality
CCTAGCTGTCCAGTTA-1	GoodQuality
CCTAGCTGTGGCTCCA-1	GoodQuality
CCTAGCTGTTATTCTC-1	GoodQuality
CCTAGCTGTTGTCTTT-1	LowQuality
CCTAGCTTCAGCCTAA-1	GoodQuality
CCTAGCTTCAGCTCTC-1	GoodQuality
CCTAGCTTCGCTTGTC-1	LowQuality
CCTATTAAGGGTGTTG-1	GoodQuality
CCTATTAAGTACCGGA-1	GoodQuality
CCTATTAAGTCCAGGA-1	GoodQuality
CCTATTAAGTGGAGTC-1	GoodQuality
CCTATTACACATCCAA-1	GoodQuality
CCTATTACACCGAAAG-1	GoodQuality
CCTATTACAGCGATCC-1	LowQuality
CCTATTAGTAAATGTG-1	LowQuality
CCTATTAGTACCCAAT-1	GoodQuality
CCTATTATCCAATGGT-1	GoodQuality
CCTATTATCTTCCTTC-1	GoodQuality
CCTCAGTAGACACTAA-1	LowQuality
CCTCAGTAGACCGGAT-1	GoodQuality
CCTCAGTAGAGGACGG-1	GoodQuality
CCTCAGTAGATGTGGC-1	GoodQuality
CCTCAGTAGCGATTCT-1	GoodQuality
CCTCAGTAGCGTAGTG-1	GoodQuality
CCTCAGTAGGCGCTCT-1	LowQuality
CCTCAGTAGGTGATTA-1	LowQuality
CCTCAGTCAACTGGCC-1	GoodQuality
CCTCAGTCACGCATCG-1	LowQuality
CCTCAGTCACTTAAGC-1	LowQuality
CCTCAGTCATGCCCGA-1	LowQuality
CCTCAGTCATGGTCTA-1	GoodQuality
CCTCAGTGTAATAGCA-1	GoodQuality
CCTCAGTGTCTTCGTC-1	LowQuality
CCTCAGTGTGTGGCTC-1	GoodQuality
CCTCAGTTCAACCAAC-1	LowQuality
CCTCAGTTCAGATAAG-1	LowQuality
CCTCTGAAGCAGCCTC-1	GoodQuality
CCTCTGAAGCCTCGTG-1	GoodQuality
CCTCTGAAGCGTTGCC-1	LowQuality
CCTCTGAAGCTACCTA-1	GoodQuality
CCTCTGACAAACGCGA-1	LowQuality
CCTCTGACACCAGATT-1	GoodQuality
CCTCTGACACGCGAAA-1	GoodQuality
CCTCTGACAGACAAAT-1	LowQuality
CCTCTGACAGTAGAGC-1	GoodQuality
CCTCTGACATACTCTT-1	GoodQuality
CCTCTGAGTAGCTAAA-1	GoodQuality
CCTCTGAGTCATGCAT-1	LowQuality
CCTCTGAGTGTTAAGA-1	GoodQuality
CCTCTGAGTTCCTCCA-1	LowQuality
CCTCTGAGTTCGTGAT-1	LowQuality
CCTCTGAGTTCTGGTA-1	GoodQuality
CCTCTGAGTTTGCATG-1	GoodQuality
CCTCTGATCAGTACGT-1	LowQuality
CCTCTGATCATCACCC-1	GoodQuality
CCTCTGATCTCACATT-1	GoodQuality
CCTTACGAGAATCTCC-1	LowQuality
CCTTACGAGAATTGTG-1	GoodQuality
CCTTACGAGGACACCA-1	GoodQuality
CCTTACGCAAGTTAAG-1	GoodQuality
CCTTACGCACTTCTGC-1	GoodQuality
CCTTACGCAGCGATCC-1	GoodQuality
CCTTACGGTCCCGACA-1	LowQuality
CCTTACGGTGGGTCAA-1	LowQuality
CCTTACGGTTCCAACA-1	GoodQuality
CCTTACGTCAGTTGAC-1	GoodQuality
CCTTACGTCCAGTATG-1	LowQuality
CCTTACGTCGGAATCT-1	GoodQuality
CCTTACGTCTTGTATC-1	GoodQuality
CCTTCCCAGATCGGGT-1	GoodQuality
CCTTCCCAGCCGGTAA-1	GoodQuality
CCTTCCCAGGTCATCT-1	GoodQuality
CCTTCCCCAGACAAAT-1	LowQuality
CCTTCCCCATATACCG-1	GoodQuality
CCTTCCCTCACAAACC-1	GoodQuality
CCTTCCCTCATCACCC-1	GoodQuality
CCTTCCCTCATCGGAT-1	LowQuality
CCTTCCCTCCTATGTT-1	GoodQuality
CCTTCCCTCGCTTAGA-1	GoodQuality
CCTTCCCTCGTCCGTT-1	GoodQuality
CCTTCCCTCTAGAGTC-1	GoodQuality
CCTTCCCTCTATCCTA-1	LowQuality
CCTTCCCTCTCTTGAT-1	LowQuality
CCTTCGAAGAAACCTA-1	GoodQuality
CCTTCGAAGAAGGACA-1	GoodQuality
CCTTCGAAGCCACGTC-1	LowQuality
CCTTCGAAGTCTCCTC-1	GoodQuality
CCTTCGAAGTGGACGT-1	GoodQuality
CCTTCGACAAAGGCGT-1	LowQuality
CCTTCGACAAGACGTG-1	GoodQuality
CCTTCGAGTAGCTTGT-1	GoodQuality
CCTTCGAGTATTCGTG-1	GoodQuality
CCTTCGAGTCTAAAGA-1	LowQuality
CCTTCGATCCACGACG-1	GoodQuality
CCTTCGATCTGTACGA-1	LowQuality
CCTTTCTAGACCACGA-1	LowQuality
CCTTTCTCACATCCAA-1	GoodQuality
CCTTTCTCACGGTTTA-1	LowQuality
CCTTTCTCAGGGCATA-1	GoodQuality
CCTTTCTGTAAGTGGC-1	GoodQuality
CCTTTCTGTAGGAGTC-1	LowQuality
CCTTTCTGTCGTGGCT-1	LowQuality
CCTTTCTGTGACGCCT-1	LowQuality
CCTTTCTGTGGGTATG-1	GoodQuality
CCTTTCTGTTCCCGAG-1	GoodQuality
CCTTTCTTCGAACTGT-1	GoodQuality
CCTTTCTTCGCAAACT-1	GoodQuality
CGAACATAGAGACTAT-1	GoodQuality
CGAACATAGCCCAGCT-1	GoodQuality
CGAACATAGGATGTAT-1	GoodQuality
CGAACATAGGATTCGG-1	GoodQuality
CGAACATAGTAACCCT-1	LowQuality
CGAACATCAAGGTTTC-1	GoodQuality
CGAACATCAATGGACG-1	GoodQuality
CGAACATCAGCTCGCA-1	GoodQuality
CGAACATGTACCGGCT-1	GoodQuality
CGAACATGTAGCTTGT-1	GoodQuality
CGAACATGTCACCCAG-1	GoodQuality
CGAACATGTCGGCTCA-1	GoodQuality
CGAACATGTCTAGTCA-1	GoodQuality
CGAACATGTGAACCTT-1	GoodQuality
CGAACATGTGCCTTGG-1	LowQuality
CGAACATTCAACTCTT-1	GoodQuality
CGAACATTCATCTGCC-1	GoodQuality
CGAACATTCCAGAGGA-1	LowQuality
CGAACATTCGGTGTTA-1	GoodQuality
CGAACATTCTGCCCTA-1	GoodQuality
CGAATGTAGGTCATCT-1	GoodQuality
CGAATGTCAGTCAGCC-1	GoodQuality
CGAATGTCATTAGCCA-1	GoodQuality
CGAATGTGTAACGTTC-1	LowQuality
CGAATGTTCCACGAAT-1	GoodQuality
CGAATGTTCGCCATAA-1	GoodQuality
CGAATGTTCGTAGATC-1	GoodQuality
CGAATGTTCTAACTGG-1	GoodQuality
CGAATGTTCTCCTATA-1	LowQuality
CGACCTTAGAGACTAT-1	GoodQuality
CGACCTTAGCTCCCAG-1	GoodQuality
CGACCTTAGTAACCCT-1	GoodQuality
CGACCTTAGTAGGCCA-1	LowQuality
CGACCTTCAAGCGCTC-1	LowQuality
CGACCTTCAAGGTTTC-1	LowQuality
CGACCTTCAGGACCCT-1	GoodQuality
CGACCTTGTAAGTGTA-1	LowQuality
CGACCTTGTCCCTACT-1	GoodQuality
CGACCTTGTCGCCATG-1	GoodQuality
CGACCTTGTGATGTCT-1	GoodQuality
CGACCTTGTTCAACCA-1	GoodQuality
CGACCTTTCAGGTAAA-1	LowQuality
CGACCTTTCGCCTGAG-1	GoodQuality
CGACTTCAGAGGTACC-1	GoodQuality
CGACTTCAGATCCTGT-1	GoodQuality
CGACTTCAGTGATCGG-1	GoodQuality
CGACTTCCACGGCTAC-1	LowQuality
CGACTTCCATATGCTG-1	GoodQuality
CGACTTCGTATTAGCC-1	GoodQuality
CGACTTCGTCAAGCGA-1	GoodQuality
CGACTTCGTCACTGGC-1	LowQuality
CGACTTCGTGTAAGTA-1	GoodQuality
CGACTTCTCAAACCAC-1	GoodQuality
CGACTTCTCACGCATA-1	GoodQuality
CGACTTCTCCTGTAGA-1	GoodQuality
CGACTTCTCTGAGGGA-1	GoodQuality
CGACTTCTCTGTTTGT-1	GoodQuality
CGACTTCTCTTGCAAG-1	LowQuality
CGAGAAGAGTAGATGT-1	GoodQuality
CGAGAAGAGTCGCCGT-1	GoodQuality
CGAGAAGCAAGCCGTC-1	LowQuality
CGAGAAGCACGAAATA-1	LowQuality
CGAGAAGGTCAAAGAT-1	GoodQuality
CGAGAAGGTCAGAGGT-1	LowQuality
CGAGAAGGTCTTCAAG-1	LowQuality
CGAGAAGGTGCAGGTA-1	GoodQuality
CGAGAAGGTGTGGTTT-1	LowQuality
CGAGCACAGAATAGGG-1	GoodQuality
CGAGCACAGCCCGAAA-1	GoodQuality
CGAGCACAGCTGTCTA-1	LowQuality
CGAGCACAGTGGTAGC-1	GoodQuality
CGAGCACCACAGACAG-1	GoodQuality
CGAGCACCAGTAAGCG-1	LowQuality
CGAGCACCAGTTCATG-1	GoodQuality
CGAGCACCATACAGCT-1	GoodQuality
CGAGCACGTCATCGGC-1	LowQuality
CGAGCACGTCTCTTTA-1	LowQuality
CGAGCACGTGCATCTA-1	GoodQuality
CGAGCACTCAGCAACT-1	GoodQuality
CGAGCACTCTGCAGTA-1	LowQuality
CGAGCACTCTTCCTTC-1	GoodQuality
CGAGCCAAGGAGTAGA-1	GoodQuality
CGAGCCAAGGGTCGAT-1	GoodQuality
CGAGCCACAAGCTGTT-1	LowQuality
CGAGCCACAAGTCTGT-1	GoodQuality
CGAGCCACACCCATTC-1	GoodQuality
CGAGCCACATGCAATC-1	LowQuality
CGAGCCAGTCAACATC-1	LowQuality
CGAGCCAGTCAACTGT-1	GoodQuality
CGAGCCAGTCGCTTTC-1	GoodQuality
CGAGCCAGTGTGTGCC-1	GoodQuality
CGAGCCAGTTCAACCA-1	GoodQuality
CGATCGGCAGTACACT-1	GoodQuality
CGATCGGCAGTATAAG-1	LowQuality
CGATCGGCAGTTAACC-1	GoodQuality
CGATCGGCATGAACCT-1	GoodQuality
CGATCGGGTCTCACCT-1	LowQuality
CGATCGGTCCTTCAAT-1	LowQuality
CGATCGGTCTGGAGCC-1	LowQuality
CGATGGCAGATATACG-1	GoodQuality
CGATGGCAGCAATATG-1	GoodQuality
CGATGGCAGGCCATAG-1	LowQuality
CGATGGCAGTAAGTAC-1	GoodQuality
CGATGGCAGTATCTCG-1	GoodQuality
CGATGGCAGTGAACGC-1	GoodQuality
CGATGGCCAAGCCATT-1	LowQuality
CGATGGCCAAGCTGGA-1	GoodQuality
CGATGGCCAGCATGAG-1	LowQuality
CGATGGCCATATGGTC-1	GoodQuality
CGATGGCGTACTTGAC-1	GoodQuality
CGATGGCGTCGCCATG-1	LowQuality
CGATGGCGTGAACCTT-1	GoodQuality
CGATGGCGTTCAGGCC-1	GoodQuality
CGATGGCGTTGACGTT-1	LowQuality
CGATGGCGTTGCCTCT-1	GoodQuality
CGATGGCTCCACGTTC-1	LowQuality
CGATGGCTCCAGATCA-1	GoodQuality
CGATGGCTCGTCTGCT-1	GoodQuality
CGATGTAAGGCGATAC-1	GoodQuality
CGATGTACAAAGGAAG-1	LowQuality
CGATGTACACAGCGTC-1	GoodQuality
CGATGTACACGGCGTT-1	GoodQuality
CGATGTACACTTACGA-1	GoodQuality
CGATGTACAGACAAAT-1	GoodQuality
CGATGTACATATACGC-1	GoodQuality
CGATGTACATCAGTAC-1	GoodQuality
CGATGTAGTTCCATGA-1	LowQuality
CGATGTATCAGAAATG-1	GoodQuality
CGATGTATCGTGGTCG-1	GoodQuality
CGATGTATCTCGTTTA-1	GoodQuality
CGATTGAAGACACTAA-1	LowQuality
CGATTGAAGCTGTCTA-1	GoodQuality
CGATTGAAGGCGCTCT-1	GoodQuality
CGATTGAGTCCGAATT-1	GoodQuality
CGATTGAGTCTAAACC-1	GoodQuality
CGATTGAGTTGACGTT-1	GoodQuality
CGATTGAGTTGTACAC-1	GoodQuality
CGATTGATCACGGTTA-1	LowQuality
CGATTGATCGCATGGC-1	LowQuality
CGATTGATCGGTCTAA-1	GoodQuality
CGCCAAGAGAGCTGGT-1	GoodQuality
CGCCAAGAGGACCACA-1	GoodQuality
CGCCAAGCACCACGTG-1	GoodQuality
CGCCAAGCAGCTGTTA-1	LowQuality
CGCCAAGCAGCTTCGG-1	GoodQuality
CGCCAAGGTACTTCTT-1	LowQuality
CGCCAAGGTGCCTGGT-1	GoodQuality
CGCCAAGGTGTAATGA-1	GoodQuality
CGCCAAGGTTCCTCCA-1	GoodQuality
CGCCAAGGTTGTTTGG-1	GoodQuality
CGCCAAGTCAGAGACG-1	LowQuality
CGCGGTAAGCGAGAAA-1	GoodQuality
CGCGGTACAAGGCTCC-1	LowQuality
CGCGGTACACGTCTCT-1	GoodQuality
CGCGGTAGTAAACGCG-1	GoodQuality
CGCGGTAGTGCACTTA-1	LowQuality
CGCGTTTAGAGCCCAA-1	LowQuality
CGCGTTTAGCACCGTC-1	GoodQuality
CGCGTTTCACAGACAG-1	LowQuality
CGCGTTTCACGCGAAA-1	GoodQuality
CGCGTTTCAGTAAGCG-1	GoodQuality
CGCGTTTCAGTCCTTC-1	GoodQuality
CGCGTTTGTCCTGCTT-1	LowQuality
CGCGTTTGTCTCCACT-1	GoodQuality
CGCGTTTGTCTGATTG-1	GoodQuality
CGCGTTTGTGAGTATA-1	GoodQuality
CGCGTTTGTTCCCGAG-1	GoodQuality
CGCGTTTTCAGAAATG-1	GoodQuality
CGCGTTTTCCCTCTTT-1	GoodQuality
CGCGTTTTCGAATGCT-1	GoodQuality
CGCTATCAGAACTCGG-1	LowQuality
CGCTATCAGCAATATG-1	GoodQuality
CGCTATCAGTTAGCGG-1	GoodQuality
CGCTATCCAAGCGCTC-1	GoodQuality
CGCTATCCAAGGACAC-1	GoodQuality
CGCTATCCATGAACCT-1	GoodQuality
CGCTATCGTAGCGATG-1	GoodQuality
CGCTATCGTGATGATA-1	GoodQuality
CGCTATCGTGCAACTT-1	GoodQuality
CGCTATCGTTGGACCC-1	GoodQuality
CGCTATCGTTTACTCT-1	GoodQuality
CGCTATCTCAGCAACT-1	LowQuality
CGCTGGAAGGCTCATT-1	GoodQuality
CGCTGGAAGGGTGTTG-1	GoodQuality
CGCTGGAAGTTAAGTG-1	LowQuality
CGCTGGACAGCTGTGC-1	LowQuality
CGCTGGAGTAGCGATG-1	GoodQuality
CGCTGGAGTGCGATAG-1	LowQuality
CGCTGGATCAACACAC-1	LowQuality
CGCTGGATCATAACCG-1	GoodQuality
CGCTGGATCATCGGAT-1	LowQuality
CGCTTCAAGAATCTCC-1	GoodQuality
CGCTTCAAGGTGCTTT-1	GoodQuality
CGCTTCAAGTGGAGTC-1	LowQuality
CGCTTCAAGTGGGCTA-1	LowQuality
CGCTTCACAAGTTAAG-1	GoodQuality
CGCTTCACAGTCTTCC-1	GoodQuality
CGCTTCAGTACAAGTA-1	LowQuality
CGCTTCAGTACCGTTA-1	GoodQuality
CGCTTCAGTAGCTCCG-1	GoodQuality
CGCTTCAGTCTACCTC-1	GoodQuality
CGCTTCATCCTTGACC-1	GoodQuality
CGCTTCATCTTACCGC-1	LowQuality
CGGACACAGATGCCAG-1	GoodQuality
CGGACACAGGCAATTA-1	GoodQuality
CGGACACAGGGTTCCC-1	GoodQuality
CGGACACCAGCCAATT-1	GoodQuality
CGGACACCAGCTGTAT-1	LowQuality
CGGACACCATTGAGCT-1	GoodQuality
CGGACACGTAAGAGAG-1	GoodQuality
CGGACACGTAGGCATG-1	GoodQuality
CGGACACGTCGTCTTC-1	LowQuality
CGGACACGTGCCTGCA-1	GoodQuality
CGGACACGTGTGGCTC-1	GoodQuality
CGGACACTCATTGCCC-1	GoodQuality
CGGACACTCCGAACGC-1	GoodQuality
CGGACACTCCTTCAAT-1	GoodQuality
CGGACACTCGTTGACA-1	LowQuality
CGGACGTAGGCAGTCA-1	GoodQuality
CGGACGTCAAGCCGTC-1	GoodQuality
CGGACGTCAATCCGAT-1	GoodQuality
CGGACGTCACAAGACG-1	LowQuality
CGGACGTCAGCGTTCG-1	LowQuality
CGGACGTCATATGCTG-1	LowQuality
CGGACGTCATCGTCGG-1	GoodQuality
CGGACGTCATGTAGTC-1	LowQuality
CGGACGTGTACCAGTT-1	LowQuality
CGGACGTGTCAGATAA-1	GoodQuality
CGGACGTGTCTCTCTG-1	GoodQuality
CGGACGTGTGTGCGTC-1	GoodQuality
CGGACGTGTTACGTCA-1	GoodQuality
CGGACGTGTTCCACTC-1	LowQuality
CGGACGTGTTCTGGTA-1	GoodQuality
CGGACGTTCAAACAAG-1	GoodQuality
CGGACGTTCCAATGGT-1	GoodQuality
CGGACTGAGCGTCAAG-1	GoodQuality
CGGACTGAGGATGTAT-1	LowQuality
CGGACTGAGGCGATAC-1	GoodQuality
CGGACTGCAATCCAAC-1	LowQuality
CGGACTGCACATTAGC-1	LowQuality
CGGACTGCATTACGAC-1	GoodQuality
CGGACTGCATTATCTC-1	GoodQuality
CGGACTGGTCGAATCT-1	GoodQuality
CGGACTGGTTACCAGT-1	LowQuality
CGGACTGGTTGGGACA-1	GoodQuality
CGGACTGTCGAATGCT-1	GoodQuality
CGGACTGTCTTGTACT-1	GoodQuality
CGGAGCTAGATGTTAG-1	GoodQuality
CGGAGCTAGGATCGCA-1	GoodQuality
CGGAGCTAGGTCGGAT-1	GoodQuality
CGGAGCTCAATAGCGG-1	GoodQuality
CGGAGCTCATTAGCCA-1	LowQuality
CGGAGCTGTCGGATCC-1	GoodQuality
CGGAGCTTCGTTGACA-1	LowQuality
CGGAGTCAGACAAAGG-1	LowQuality
CGGAGTCCATTATCTC-1	GoodQuality
CGGAGTCGTATAGTAG-1	GoodQuality
CGGAGTCGTATGCTTG-1	GoodQuality
CGGAGTCGTCAATGTC-1	GoodQuality
CGGAGTCGTCCGAGTC-1	GoodQuality
CGGAGTCGTCCGTCAG-1	GoodQuality
CGGAGTCTCACCTCGT-1	GoodQuality
CGGCTAGAGGAATCGC-1	GoodQuality
CGGCTAGAGTACGATA-1	GoodQuality
CGGCTAGAGTCTCGGC-1	GoodQuality
CGGCTAGCATTCCTGC-1	GoodQuality
CGGCTAGGTAGCTTGT-1	GoodQuality
CGGCTAGGTCCATGAT-1	GoodQuality
CGGCTAGGTCTAAAGA-1	GoodQuality
CGGCTAGTCAGCGACC-1	LowQuality
CGGGTCAAGGAGCGTT-1	LowQuality
CGGGTCAAGGTGCACA-1	GoodQuality
CGGGTCAAGTGAAGTT-1	LowQuality
CGGGTCAAGTGTACGG-1	GoodQuality
CGGGTCACATCCGCGA-1	LowQuality
CGGGTCAGTCCGTTAA-1	LowQuality
CGGGTCATCACGCGGT-1	GoodQuality
CGGGTCATCGCGGATC-1	GoodQuality
CGGGTCATCTTAGCCC-1	GoodQuality
CGGGTCATCTTCAACT-1	GoodQuality
CGGTTAAAGGCAATTA-1	GoodQuality
CGGTTAAAGGGATGGG-1	GoodQuality
CGGTTAAAGTGTACGG-1	GoodQuality
CGGTTAACAAGTTGTC-1	LowQuality
CGGTTAACAGGTGGAT-1	GoodQuality
CGGTTAACATGCCTAA-1	GoodQuality
CGGTTAACATGGAATA-1	LowQuality
CGGTTAACATTCTCAT-1	LowQuality
CGGTTAAGTATAATGG-1	GoodQuality
CGGTTAAGTTAAGTAG-1	GoodQuality
CGGTTAAGTTGGACCC-1	GoodQuality
CGGTTAATCCCTCTTT-1	GoodQuality
CGGTTAATCGCGATCG-1	LowQuality
CGTAGCGAGAGCTGGT-1	GoodQuality
CGTAGCGAGATGCCTT-1	GoodQuality
CGTAGCGAGGACAGAA-1	GoodQuality
CGTAGCGAGTATTGGA-1	GoodQuality
CGTAGCGCAATACGCT-1	LowQuality
CGTAGCGCAGCTCGAC-1	GoodQuality
CGTAGCGCATACAGCT-1	LowQuality
CGTAGCGGTATAATGG-1	LowQuality
CGTAGCGGTATAGGGC-1	GoodQuality
CGTAGCGGTATGAATG-1	GoodQuality
CGTAGCGGTCAAGCGA-1	GoodQuality
CGTAGCGGTGGGTATG-1	GoodQuality
CGTAGCGGTGTTTGGT-1	GoodQuality
CGTAGCGGTTCGGGCT-1	GoodQuality
CGTAGCGGTTCTGTTT-1	GoodQuality
CGTAGCGTCTAAGCCA-1	GoodQuality
CGTAGGCAGAGAGCTC-1	GoodQuality
CGTAGGCAGCCAGAAC-1	LowQuality
CGTAGGCAGGCTAGCA-1	GoodQuality
CGTAGGCAGGTGCAAC-1	GoodQuality
CGTAGGCAGTAACCCT-1	GoodQuality
CGTAGGCCACGTCTCT-1	GoodQuality
CGTAGGCCAGCGTAAG-1	GoodQuality
CGTAGGCCAGGAATCG-1	GoodQuality
CGTAGGCCAGTAACGG-1	GoodQuality
CGTAGGCCATTGGCGC-1	GoodQuality
CGTAGGCGTAAGTAGT-1	GoodQuality
CGTAGGCGTCGCGTGT-1	GoodQuality
CGTAGGCGTGATAAGT-1	GoodQuality
CGTAGGCTCACCCTCA-1	LowQuality
CGTAGGCTCCACGTTC-1	GoodQuality
CGTAGGCTCCTTCAAT-1	GoodQuality
CGTAGGCTCTCGCTTG-1	GoodQuality
CGTAGGCTCTGACCTC-1	GoodQuality
CGTCACTAGGAGCGTT-1	GoodQuality
CGTCACTCAAACCCAT-1	GoodQuality
CGTCACTCACGCTTTC-1	LowQuality
CGTCACTCAGATCCAT-1	GoodQuality
CGTCACTGTAGTAGTA-1	LowQuality
CGTCACTGTATCACCA-1	GoodQuality
CGTCACTGTCTAGCGC-1	GoodQuality
CGTCACTGTCTTTCAT-1	LowQuality
CGTCACTGTGAGTGAC-1	GoodQuality
CGTCACTGTTCCATGA-1	GoodQuality
CGTCACTGTTGGACCC-1	GoodQuality
CGTCAGGAGAAACGAG-1	LowQuality
CGTCAGGAGCTATGCT-1	LowQuality
CGTCAGGAGGTGTGGT-1	GoodQuality
CGTCAGGAGTCACGCC-1	LowQuality
CGTCAGGCAGTCACTA-1	GoodQuality
CGTCAGGGTAAAGGAG-1	GoodQuality
CGTCAGGGTAGCGCAA-1	GoodQuality
CGTCAGGGTCATCCCT-1	GoodQuality
CGTCAGGGTTCCACGG-1	GoodQuality
CGTCCATAGACTTTCG-1	GoodQuality
CGTCCATAGCCACTAT-1	GoodQuality
CGTCCATAGTATGACA-1	GoodQuality
CGTCCATAGTGTACTC-1	GoodQuality
CGTCCATGTAAATGTG-1	GoodQuality
CGTCTACAGCACACAG-1	GoodQuality
CGTCTACAGCCAGGAT-1	GoodQuality
CGTCTACAGCGGCTTC-1	GoodQuality
CGTCTACAGGGTGTGT-1	LowQuality
CGTCTACAGTACGTAA-1	LowQuality
CGTCTACCAAGCCGCT-1	LowQuality
CGTCTACGTAAGAGAG-1	GoodQuality
CGTCTACGTATAATGG-1	GoodQuality
CGTCTACGTGATAAGT-1	LowQuality
CGTCTACGTTAAGTAG-1	LowQuality
CGTCTACTCCTAGGGC-1	GoodQuality
CGTCTACTCGTCTGAA-1	GoodQuality
CGTCTACTCTCTGTCG-1	GoodQuality
CGTGAGCAGCAGATCG-1	GoodQuality
CGTGAGCAGGGATGGG-1	GoodQuality
CGTGAGCCAGCTCGAC-1	LowQuality
CGTGAGCCAGCTTCGG-1	LowQuality
CGTGAGCGTAAATACG-1	GoodQuality
CGTGAGCGTATCAGTC-1	LowQuality
CGTGAGCGTCCAACTA-1	GoodQuality
CGTGAGCTCATGGTCA-1	GoodQuality
CGTGAGCTCGTAGGTT-1	GoodQuality
CGTGAGCTCTCCAGGG-1	GoodQuality
CGTGAGCTCTTGAGAC-1	GoodQuality
CGTGTAAAGGTGCAAC-1	LowQuality
CGTGTAACAGCCTGTG-1	GoodQuality
CGTGTAACAGGAATCG-1	GoodQuality
CGTGTAAGTACGAAAT-1	GoodQuality
CGTGTAAGTCGTTGTA-1	LowQuality
CGTGTAAGTTACGGAG-1	GoodQuality
CGTGTAATCCGAAGAG-1	GoodQuality
CGTGTAATCGAACTGT-1	GoodQuality
CGTGTCTAGAACTCGG-1	GoodQuality
CGTGTCTCACGAGAGT-1	LowQuality
CGTGTCTCAGCCAGAA-1	GoodQuality
CGTGTCTGTACCATCA-1	GoodQuality
CGTGTCTGTAGCTCCG-1	LowQuality
CGTGTCTGTCAATACC-1	GoodQuality
CGTGTCTGTTCCTCCA-1	GoodQuality
CGTGTCTGTTCGTCTC-1	LowQuality
CGTGTCTTCCAAACAC-1	GoodQuality
CGTGTCTTCCGGGTGT-1	GoodQuality
CGTGTCTTCTTCATGT-1	GoodQuality
CGTTAGAAGCCCAACC-1	GoodQuality
CGTTAGAAGGGATACC-1	LowQuality
CGTTAGATCAGAGGTG-1	GoodQuality
CGTTAGATCAGATAAG-1	GoodQuality
CGTTAGATCAGTCCCT-1	LowQuality
CGTTAGATCATGGTCA-1	GoodQuality
CGTTCTGAGCCACTAT-1	LowQuality
CGTTCTGAGCCAGTTT-1	LowQuality
CGTTCTGAGGAATCGC-1	GoodQuality
CGTTCTGAGGATGGTC-1	LowQuality
CGTTCTGAGTCAATAG-1	GoodQuality
CGTTCTGCAGAGCCAA-1	GoodQuality
CGTTCTGCATCGACGC-1	LowQuality
CGTTCTGCATCGTCGG-1	GoodQuality
CGTTCTGGTGAAATCA-1	GoodQuality
CGTTCTGTCATTTGGG-1	LowQuality
CGTTCTGTCTTGTTTG-1	GoodQuality
CGTTGGGAGACCCACC-1	GoodQuality
CGTTGGGAGACTACAA-1	GoodQuality
CGTTGGGAGAGGACGG-1	GoodQuality
CGTTGGGAGAGGTTGC-1	GoodQuality
CGTTGGGAGCTCCCAG-1	GoodQuality
CGTTGGGAGTAGGCCA-1	GoodQuality
CGTTGGGCACAGTCGC-1	LowQuality
CGTTGGGCACCAACCG-1	GoodQuality
CGTTGGGCACCGATAT-1	GoodQuality
CGTTGGGGTCCAAGTT-1	GoodQuality
CGTTGGGGTCGACTAT-1	GoodQuality
CGTTGGGGTTATGTGC-1	GoodQuality
CGTTGGGTCAGTTGAC-1	LowQuality
CGTTGGGTCATCTGTT-1	LowQuality
CGTTGGGTCCCTGACT-1	LowQuality
CTAACTTAGACGCAAC-1	GoodQuality
CTAACTTAGGCTCAGA-1	GoodQuality
CTAACTTAGTAGATGT-1	GoodQuality
CTAACTTCAAGGACTG-1	GoodQuality
CTAACTTCACAGGTTT-1	GoodQuality
CTAACTTCACTGTTAG-1	GoodQuality
CTAACTTGTCCGTCAG-1	GoodQuality
CTAACTTGTGCAACGA-1	GoodQuality
CTAACTTGTGCAACTT-1	GoodQuality
CTAACTTTCAAAGTAG-1	LowQuality
CTAACTTTCAATAAGG-1	GoodQuality
CTAACTTTCACCCTCA-1	GoodQuality
CTAACTTTCACCGTAA-1	GoodQuality
CTAACTTTCCAAACAC-1	GoodQuality
CTAACTTTCCGCAGTG-1	LowQuality
CTAACTTTCTGCGGCA-1	GoodQuality
CTAAGACAGATATACG-1	GoodQuality
CTAAGACAGCCACGCT-1	GoodQuality
CTAAGACAGCTAGGCA-1	GoodQuality
CTAAGACAGGACAGAA-1	GoodQuality
CTAAGACAGTCCAGGA-1	GoodQuality
CTAAGACAGTTCCACA-1	GoodQuality
CTAAGACCACGCTTTC-1	GoodQuality
CTAAGACCAGTTAACC-1	GoodQuality
CTAAGACCATGTCCTC-1	LowQuality
CTAAGACCATTATCTC-1	LowQuality
CTAAGACCATTGCGGC-1	GoodQuality
CTAAGACCATTGGTAC-1	GoodQuality
CTAAGACGTCAAAGAT-1	LowQuality
CTAAGACGTCATATGC-1	GoodQuality
CTAAGACGTCTCGTTC-1	GoodQuality
CTAAGACGTCTTCGTC-1	GoodQuality
CTAAGACGTGAAAGAG-1	GoodQuality
CTAAGACGTTATTCTC-1	LowQuality
CTAAGACTCACTCCTG-1	GoodQuality
CTAAGACTCCACGTTC-1	GoodQuality
CTAAGACTCGGCGGTT-1	LowQuality
CTAAGACTCGTCCGTT-1	GoodQuality
CTAAGACTCTACCAGA-1	GoodQuality
CTAAGACTCTCAACTT-1	LowQuality
CTAAGACTCTTACCGC-1	GoodQuality
CTAATGGAGAAGGCCT-1	LowQuality
CTAATGGAGACTTGAA-1	LowQuality
CTAATGGAGGATGTAT-1	LowQuality
CTAATGGCAAACTGTC-1	LowQuality
CTAATGGCAACCGCCA-1	GoodQuality
CTAATGGCACAACTGT-1	GoodQuality
CTAATGGCAGGATTGG-1	GoodQuality
CTAATGGCAGTCCTTC-1	GoodQuality
CTAATGGCATTGCGGC-1	GoodQuality
CTAATGGGTACTTCTT-1	LowQuality
CTAATGGGTAGCGTCC-1	GoodQuality
CTAATGGGTCGACTGC-1	GoodQuality
CTAATGGGTCTAGAGG-1	LowQuality
CTAATGGGTCTCTTTA-1	GoodQuality
CTAATGGGTTCGCTAA-1	GoodQuality
CTAATGGTCACGATGT-1	GoodQuality
CTAATGGTCCAATGGT-1	GoodQuality
CTAATGGTCCGTCAAA-1	LowQuality
CTAATGGTCGTTACAG-1	LowQuality
CTAATGGTCTCCCTGA-1	GoodQuality
CTACACCAGGTGGGTT-1	GoodQuality
CTACACCAGTACACCT-1	GoodQuality
CTACACCAGTACTTGC-1	GoodQuality
CTACACCAGTGTTAGA-1	GoodQuality
CTACACCCAATCCAAC-1	GoodQuality
CTACACCCACAAGACG-1	GoodQuality
CTACACCCACTGTGTA-1	GoodQuality
CTACACCCATGGGACA-1	LowQuality
CTACACCGTAGAAAGG-1	GoodQuality
CTACACCGTCACACGC-1	GoodQuality
CTACACCGTCAGGACA-1	LowQuality
CTACACCGTCATATCG-1	GoodQuality
CTACACCTCATGCATG-1	GoodQuality
CTACACCTCCCGGATG-1	LowQuality
CTACACCTCCGATATG-1	LowQuality
CTACACCTCGACCAGC-1	GoodQuality
CTACACCTCGCCAAAT-1	LowQuality
CTACATTAGATAGCAT-1	LowQuality
CTACATTAGGCTAGAC-1	GoodQuality
CTACATTAGTGAATTG-1	GoodQuality
CTACATTCAAGCCCAC-1	GoodQuality
CTACATTCAAGGTTCT-1	GoodQuality
CTACATTCACTCGACG-1	LowQuality
CTACATTCATCCAACA-1	LowQuality
CTACATTGTAGTAGTA-1	GoodQuality
CTACATTGTATTCTCT-1	GoodQuality
CTACATTGTCGAGATG-1	GoodQuality
CTACATTGTCTGCAAT-1	LowQuality
CTACATTGTGTGAATA-1	GoodQuality
CTACATTTCCAGTAGT-1	GoodQuality
CTACATTTCCGCAGTG-1	LowQuality
CTACCCAAGACCACGA-1	GoodQuality
CTACCCAAGCAGATCG-1	GoodQuality
CTACCCAAGCAGCCTC-1	GoodQuality
CTACCCAAGCCCTAAT-1	GoodQuality
CTACCCAAGGATATAC-1	GoodQuality
CTACCCACAAGACACG-1	GoodQuality
CTACCCACAATCACAC-1	GoodQuality
CTACCCACAATCTGCA-1	GoodQuality
CTACCCACACAGGAGT-1	LowQuality
CTACCCACACATCCAA-1	GoodQuality
CTACCCACACTGCCAG-1	GoodQuality
CTACCCAGTACTCGCG-1	GoodQuality
CTACCCAGTAGGCTGA-1	GoodQuality
CTACCCAGTTAGGGTG-1	GoodQuality
CTACCCATCGCCTGTT-1	GoodQuality
CTACCCATCGCTTGTC-1	GoodQuality
CTACGTCCAAATACAG-1	GoodQuality
CTACGTCGTAATTGGA-1	GoodQuality
CTACGTCGTAGGACAC-1	LowQuality
CTACGTCGTGGCGAAT-1	LowQuality
CTACGTCTCAGCTGGC-1	GoodQuality
CTACGTCTCCACTCCA-1	LowQuality
CTACGTCTCGGAATCT-1	GoodQuality
CTACGTCTCTCTGCTG-1	LowQuality
CTAGAGTAGATCCCAT-1	LowQuality
CTAGAGTAGCCCAGCT-1	GoodQuality
CTAGAGTAGGAATCGC-1	GoodQuality
CTAGAGTAGGCACATG-1	LowQuality
CTAGAGTAGGTACTCT-1	GoodQuality
CTAGAGTAGTTGAGTA-1	GoodQuality
CTAGAGTCACACGCTG-1	GoodQuality
CTAGAGTCACGAGAGT-1	GoodQuality
CTAGAGTCAGATCGGA-1	GoodQuality
CTAGAGTCATACGCTA-1	GoodQuality
CTAGAGTCATACTCTT-1	LowQuality
CTAGAGTCATTAACCG-1	LowQuality
CTAGAGTGTCCGTGAC-1	GoodQuality
CTAGAGTGTTCCACAA-1	LowQuality
CTAGAGTGTTCGGCAC-1	LowQuality
CTAGAGTTCAAAGACA-1	LowQuality
CTAGAGTTCGCGTAGC-1	GoodQuality
CTAGAGTTCTCTTGAT-1	GoodQuality
CTAGCCTAGACAAAGG-1	LowQuality
CTAGCCTAGCTGAACG-1	GoodQuality
CTAGCCTGTAGCACGA-1	GoodQuality
CTAGCCTGTGGTAACG-1	GoodQuality
CTAGCCTTCAGTCCCT-1	GoodQuality
CTAGCCTTCCAACCAA-1	GoodQuality
CTAGCCTTCCTAGGGC-1	LowQuality
CTAGCCTTCCTTTACA-1	LowQuality
CTAGCCTTCGAACTGT-1	GoodQuality
CTAGCCTTCTTACCGC-1	GoodQuality
CTAGTGAAGGACACCA-1	GoodQuality
CTAGTGAAGGACAGAA-1	LowQuality
CTAGTGAAGTATCGAA-1	GoodQuality
CTAGTGACAACAACCT-1	GoodQuality
CTAGTGACACGGTAAG-1	GoodQuality
CTAGTGACATATGGTC-1	GoodQuality
CTAGTGACATGGTCTA-1	GoodQuality
CTAGTGAGTAGAGCTG-1	LowQuality
CTAGTGAGTCCTAGCG-1	GoodQuality
CTAGTGAGTCTCTTAT-1	GoodQuality
CTAGTGATCGGTCCGA-1	GoodQuality
CTAGTGATCTAGCACA-1	GoodQuality
CTAGTGATCTCGTTTA-1	GoodQuality
CTCACACAGCTGCAAG-1	GoodQuality
CTCACACAGGGTATCG-1	GoodQuality
CTCACACAGGGTCTCC-1	LowQuality
CTCACACAGTACGTAA-1	GoodQuality
CTCACACCAAAGGCGT-1	GoodQuality
CTCACACCACATCCGG-1	LowQuality
CTCACACCACCAACCG-1	LowQuality
CTCACACCAGGAATGC-1	GoodQuality
CTCACACCAGTATCTG-1	GoodQuality
CTCACACGTACTTGAC-1	GoodQuality
CTCACACGTAGCAAAT-1	GoodQuality
CTCACACGTATATGGA-1	GoodQuality
CTCACACGTGTGAATA-1	LowQuality
CTCACACGTTCATGGT-1	GoodQuality
CTCACACGTTCCCGAG-1	GoodQuality
CTCACACTCATCATTC-1	GoodQuality
CTCACACTCCAATGGT-1	GoodQuality
CTCACACTCCACTCCA-1	GoodQuality
CTCACACTCCCGGATG-1	GoodQuality
CTCACACTCGGCGCAT-1	GoodQuality
CTCAGAAAGAGGGATA-1	LowQuality
CTCAGAAAGGCATGTG-1	GoodQuality
CTCAGAAAGGCTACGA-1	GoodQuality
CTCAGAAAGTGGGTTG-1	GoodQuality
CTCAGAACAAGCTGGA-1	GoodQuality
CTCAGAACAATCTGCA-1	LowQuality
CTCAGAACAGCTATTG-1	GoodQuality
CTCAGAACATCGGAAG-1	GoodQuality
CTCAGAAGTAGAGTGC-1	GoodQuality
CTCAGAAGTCCGAATT-1	LowQuality
CTCAGAAGTCTTCTCG-1	GoodQuality
CTCAGAAGTTCAACCA-1	LowQuality
CTCAGAATCACCCGAG-1	GoodQuality
CTCAGAATCACTTCAT-1	LowQuality
CTCAGAATCGAGCCCA-1	GoodQuality
CTCAGAATCGTATCAG-1	GoodQuality
CTCAGAATCTTGAGGT-1	GoodQuality
CTCATTAAGCTTATCG-1	GoodQuality
CTCATTACAGCCTTGG-1	GoodQuality
CTCATTAGTAGTGAAT-1	GoodQuality
CTCATTAGTCCGACGT-1	GoodQuality
CTCATTAGTGTGACGA-1	GoodQuality
CTCATTAGTTAAGTAG-1	GoodQuality
CTCATTATCACATGCA-1	LowQuality
CTCATTATCATAGCAC-1	LowQuality
CTCATTATCTGGCGAC-1	GoodQuality
CTCCTAGAGCTTATCG-1	GoodQuality
CTCCTAGCAACTGGCC-1	GoodQuality
CTCCTAGCACCTTGTC-1	GoodQuality
CTCCTAGGTACCGTTA-1	GoodQuality
CTCCTAGGTAGCAAAT-1	LowQuality
CTCCTAGGTCATACTG-1	GoodQuality
CTCCTAGTCATGGTCA-1	LowQuality
CTCCTAGTCCGTAGTA-1	GoodQuality
CTCGAAAAGAGAACAG-1	LowQuality
CTCGAAAAGGACGAAA-1	GoodQuality
CTCGAAACATCGACGC-1	GoodQuality
CTCGAAAGTTAAGACA-1	GoodQuality
CTCGAAAGTTGACGTT-1	GoodQuality
CTCGAAATCAAACCAC-1	GoodQuality
CTCGAAATCCGTTGCT-1	LowQuality
CTCGAGGAGGTTACCT-1	GoodQuality
CTCGAGGCACAGGCCT-1	GoodQuality
CTCGAGGCATCCAACA-1	GoodQuality
CTCGAGGCATCCCACT-1	GoodQuality
CTCGAGGGTGAACCTT-1	LowQuality
CTCGGAGAGACAAAGG-1	GoodQuality
CTCGGAGAGCAGCGTA-1	GoodQuality
CTCGGAGCAGTCAGAG-1	GoodQuality
CTCGGAGGTAAAGTCA-1	GoodQuality
CTCGGAGGTCATATCG-1	LowQuality
CTCGGAGGTGACGCCT-1	LowQuality
CTCGGAGGTGTGTGCC-1	LowQuality
CTCGGAGGTTATCACG-1	GoodQuality
CTCGGAGTCGAATCCA-1	LowQuality
CTCGGAGTCGTCGTTC-1	GoodQuality
CTCGGGAAGCCAGGAT-1	GoodQuality
CTCGGGAAGCTCCTCT-1	GoodQuality
CTCGGGAAGGCATTGG-1	GoodQuality
CTCGGGACAATCCGAT-1	GoodQuality
CTCGGGACACAAGACG-1	GoodQuality
CTCGGGACAGATGAGC-1	GoodQuality
CTCGGGACATAGTAAG-1	GoodQuality
CTCGGGAGTAAATACG-1	LowQuality
CTCGGGAGTCTAGTCA-1	GoodQuality
CTCGGGAGTGTCAATC-1	GoodQuality
CTCGGGATCAACGGCC-1	GoodQuality
CTCGGGATCATGCAAC-1	GoodQuality
CTCGGGATCGAGGTAG-1	GoodQuality
CTCGGGATCGGAATCT-1	GoodQuality
CTCGTACAGAGCCCAA-1	GoodQuality
CTCGTACAGATGGGTC-1	GoodQuality
CTCGTACAGGATTCGG-1	GoodQuality
CTCGTACCACCAGGTC-1	GoodQuality
CTCGTACCACCGTTGG-1	LowQuality
CTCGTACCAGGTCGTC-1	GoodQuality
CTCGTACCATTAACCG-1	GoodQuality
CTCGTACGTAGCCTAT-1	GoodQuality
CTCGTACGTTCCAACA-1	LowQuality
CTCGTACTCCTCAACC-1	LowQuality
CTCGTACTCGGATGTT-1	GoodQuality
CTCGTACTCTTGAGGT-1	GoodQuality
CTCGTCAAGCGGCTTC-1	GoodQuality
CTCGTCACAAAGCAAT-1	GoodQuality
CTCGTCACAATGGTCT-1	GoodQuality
CTCGTCACAGTCCTTC-1	GoodQuality
CTCGTCACATGATCCA-1	LowQuality
CTCGTCAGTCCCTTGT-1	GoodQuality
CTCGTCATCACTTATC-1	LowQuality
CTCGTCATCATGTCCC-1	GoodQuality
CTCGTCATCCTCCTAG-1	GoodQuality
CTCGTCATCGTACCGG-1	LowQuality
CTCGTCATCGTCACGG-1	GoodQuality
CTCTAATAGTTACGGG-1	GoodQuality
CTCTAATCAAAGGTGC-1	GoodQuality
CTCTAATCAAGGTTTC-1	GoodQuality
CTCTAATCAGTATGCT-1	GoodQuality
CTCTAATCATCAGTAC-1	GoodQuality
CTCTAATCATGTTGAC-1	GoodQuality
CTCTAATGTACGCACC-1	GoodQuality
CTCTAATGTGCACTTA-1	GoodQuality
CTCTAATTCCAGTAGT-1	GoodQuality
CTCTAATTCCGTACAA-1	GoodQuality
CTCTACGAGCTGCAAG-1	GoodQuality
CTCTACGAGGCCATAG-1	LowQuality
CTCTACGCAATTCCTT-1	GoodQuality
CTCTACGCAGACGCAA-1	GoodQuality
CTCTACGCATACGCCG-1	GoodQuality
CTCTACGCATTCCTCG-1	GoodQuality
CTCTACGGTACTTCTT-1	GoodQuality
CTCTACGGTAGCTCCG-1	GoodQuality
CTCTACGGTCAGAATA-1	GoodQuality
CTCTACGGTGATGATA-1	LowQuality
CTCTACGGTGTTCGAT-1	LowQuality
CTCTACGTCCAGTAGT-1	GoodQuality
CTCTACGTCCTTAATC-1	GoodQuality
CTCTACGTCGATGAGG-1	LowQuality
CTCTACGTCTACCAGA-1	GoodQuality
CTCTGGTAGCCCAATT-1	GoodQuality
CTCTGGTAGTCCATAC-1	LowQuality
CTCTGGTGTTACCAGT-1	GoodQuality
CTCTGGTTCATGTCCC-1	GoodQuality
CTCTGGTTCGCTAGCG-1	LowQuality
CTCTGGTTCGGACAAG-1	GoodQuality
CTGAAACAGAGCCCAA-1	GoodQuality
CTGAAACAGGACTGGT-1	LowQuality
CTGAAACAGTTTCCTT-1	GoodQuality
CTGAAACCACACGCTG-1	GoodQuality
CTGAAACCACGAAATA-1	GoodQuality
CTGAAACCACGGTAAG-1	LowQuality
CTGAAACCAGGGCATA-1	LowQuality
CTGAAACCATCACCCT-1	LowQuality
CTGAAACCATGCGCAC-1	LowQuality
CTGAAACCATTCGACA-1	GoodQuality
CTGAAACGTAAACGCG-1	GoodQuality
CTGAAACGTCATATCG-1	GoodQuality
CTGAAACGTGGAAAGA-1	GoodQuality
CTGAAACGTGGCAAAC-1	LowQuality
CTGAAACTCACCTCGT-1	GoodQuality
CTGAAACTCACGACTA-1	GoodQuality
CTGAAACTCATTATCC-1	GoodQuality
CTGAAACTCGCGTTTC-1	GoodQuality
CTGAAACTCGGCATCG-1	GoodQuality
CTGAAACTCTCCAGGG-1	LowQuality
CTGAAACTCTGATACG-1	GoodQuality
CTGAAGTAGTCCGGTC-1	GoodQuality
CTGAAGTAGTCTCCTC-1	LowQuality
CTGAAGTAGTGTTAGA-1	GoodQuality
CTGAAGTCAATAACGA-1	GoodQuality
CTGAAGTCATACCATG-1	GoodQuality
CTGAAGTCATTCGACA-1	LowQuality
CTGAAGTGTAGCGTCC-1	GoodQuality
CTGAAGTGTTATGTGC-1	GoodQuality
CTGAAGTTCAGCACAT-1	GoodQuality
CTGAAGTTCATCGCTC-1	GoodQuality
CTGAAGTTCTAACTCT-1	LowQuality
CTGAAGTTCTTGCAAG-1	LowQuality
CTGATAGAGACAATAC-1	LowQuality
CTGATAGAGCGATCCC-1	GoodQuality
CTGATAGAGTCCAGGA-1	LowQuality
CTGATAGAGTTCCACA-1	LowQuality
CTGATAGCAACTTGAC-1	GoodQuality
CTGATAGCACAAGACG-1	GoodQuality
CTGATAGCACACCGCA-1	LowQuality
CTGATAGCACGGACAA-1	GoodQuality
CTGATAGCACGTCTCT-1	GoodQuality
CTGATAGGTAGCACGA-1	LowQuality
CTGATAGGTCATTAGC-1	GoodQuality
CTGATAGGTCTTTCAT-1	GoodQuality
CTGATAGTCTTCATGT-1	LowQuality
CTGATCCAGTGCGTGA-1	GoodQuality
CTGATCCCAAGAGTCG-1	GoodQuality
CTGATCCCATCAGTCA-1	GoodQuality
CTGATCCCATCATCCC-1	LowQuality
CTGATCCGTGGAAAGA-1	GoodQuality
CTGATCCTCCTTAATC-1	GoodQuality
CTGATCCTCTGCAGTA-1	GoodQuality
CTGATCCTCTTCGGTC-1	GoodQuality
CTGCCTAAGACAGGCT-1	GoodQuality
CTGCCTAAGCTAACAA-1	GoodQuality
CTGCCTAAGGATGCGT-1	GoodQuality
CTGCCTAAGTGACATA-1	LowQuality
CTGCCTACAAGTAGTA-1	LowQuality
CTGCCTACACCTTGTC-1	GoodQuality
CTGCCTAGTATATGAG-1	LowQuality
CTGCCTAGTCAACTGT-1	GoodQuality
CTGCCTAGTCCAGTTA-1	GoodQuality
CTGCCTAGTTCCCTTG-1	GoodQuality
CTGCCTATCAGCACAT-1	GoodQuality
CTGCCTATCGCGCCAA-1	LowQuality
CTGCGGAAGTACGCCC-1	LowQuality
CTGCGGACAGCTTCGG-1	GoodQuality
CTGCGGAGTACCGTAT-1	LowQuality
CTGCGGAGTAGAGCTG-1	GoodQuality
CTGCGGAGTCACAAGG-1	LowQuality
CTGCGGAGTGTGACGA-1	GoodQuality
CTGCGGATCCTCAACC-1	GoodQuality
CTGCGGATCGCTTAGA-1	LowQuality
CTGCTGTAGATCCCAT-1	GoodQuality
CTGCTGTAGGGTGTTG-1	LowQuality
CTGCTGTCACCACCAG-1	GoodQuality
CTGCTGTCACTATCTT-1	GoodQuality
CTGCTGTCACTTGGAT-1	GoodQuality
CTGCTGTCATCGATTG-1	GoodQuality
CTGCTGTCATTCCTCG-1	GoodQuality
CTGCTGTGTACGAAAT-1	GoodQuality
CTGCTGTGTCATCGGC-1	GoodQuality
CTGCTGTGTGTAAGTA-1	LowQuality
CTGCTGTGTGTTAAGA-1	GoodQuality
CTGCTGTTCAACACGT-1	GoodQuality
CTGCTGTTCAGTCAGT-1	GoodQuality
CTGCTGTTCGTGTAGT-1	GoodQuality
CTGCTGTTCTGTGCAA-1	GoodQuality
CTGCTGTTCTTGTACT-1	GoodQuality
CTGGTCTAGATATGGT-1	GoodQuality
CTGGTCTAGCACACAG-1	LowQuality
CTGGTCTAGCGCTTAT-1	GoodQuality
CTGGTCTAGGCGATAC-1	GoodQuality
CTGGTCTAGGGCTTCC-1	LowQuality
CTGGTCTAGTTGTCGT-1	GoodQuality
CTGGTCTCACACAGAG-1	GoodQuality
CTGGTCTCAGTATGCT-1	GoodQuality
CTGGTCTCATCTGGTA-1	LowQuality
CTGGTCTCATTATCTC-1	LowQuality
CTGGTCTCATTCCTCG-1	LowQuality
CTGGTCTGTACCGTAT-1	GoodQuality
CTGGTCTGTCTCCCTA-1	GoodQuality
CTGGTCTGTGAGGGAG-1	GoodQuality
CTGGTCTGTGCAGACA-1	GoodQuality
CTGGTCTGTGTGCGTC-1	GoodQuality
CTGGTCTTCAGCTCTC-1	GoodQuality
CTGGTCTTCAGGTAAA-1	GoodQuality
CTGGTCTTCTTCAACT-1	GoodQuality
CTGTGCTAGACCGGAT-1	GoodQuality
CTGTGCTAGGGCATGT-1	GoodQuality
CTGTGCTCACCGCTAG-1	GoodQuality
CTGTGCTCACGAAATA-1	LowQuality
CTGTGCTCACGTCTCT-1	LowQuality
CTGTGCTCAGTCGTGC-1	LowQuality
CTGTGCTGTAGCCTAT-1	LowQuality
CTGTGCTGTCCTCTTG-1	GoodQuality
CTGTGCTGTCTCAACA-1	GoodQuality
CTGTGCTTCAAGATCC-1	LowQuality
CTGTGCTTCACCGGGT-1	LowQuality
CTGTTTAAGTAGGCCA-1	LowQuality
CTGTTTACAAGCCGCT-1	GoodQuality
CTGTTTAGTCCATGAT-1	GoodQuality
CTGTTTAGTGATGTGG-1	LowQuality
CTGTTTAGTTGTCTTT-1	LowQuality
CTGTTTAGTTTGCATG-1	GoodQuality
CTGTTTATCAAGCCTA-1	LowQuality
CTGTTTATCACTCCTG-1	LowQuality
CTGTTTATCATTGCCC-1	GoodQuality
CTGTTTATCCAAACTG-1	LowQuality
CTGTTTATCCTTTCGG-1	GoodQuality
CTGTTTATCGCGTAGC-1	GoodQuality
CTTAACTAGAGGGATA-1	LowQuality
CTTAACTAGGGTTCCC-1	GoodQuality
CTTAACTCAAACGCGA-1	GoodQuality
CTTAACTCAAGCCGCT-1	GoodQuality
CTTAACTCATCCCACT-1	GoodQuality
CTTAACTGTCTCCACT-1	GoodQuality
CTTAACTGTCTGATCA-1	GoodQuality
CTTAACTGTCTGCCAG-1	GoodQuality
CTTAACTGTGAGGCTA-1	GoodQuality
CTTAACTTCACCACCT-1	GoodQuality
CTTAACTTCCAGATCA-1	GoodQuality
CTTAACTTCGAGCCCA-1	LowQuality
CTTAACTTCGCAAGCC-1	GoodQuality
CTTAACTTCGGCGGTT-1	LowQuality
CTTACCGAGCGTGAAC-1	LowQuality
CTTACCGAGGACCACA-1	GoodQuality
CTTACCGAGTCCTCCT-1	LowQuality
CTTACCGAGTCGCCGT-1	GoodQuality
CTTACCGAGTGACATA-1	GoodQuality
CTTACCGCACCTCGGA-1	GoodQuality
CTTACCGCAGGTGCCT-1	GoodQuality
CTTACCGCATTTGCCC-1	GoodQuality
CTTACCGGTAAGAGGA-1	LowQuality
CTTACCGGTGTTCTTT-1	GoodQuality
CTTACCGTCAAAGACA-1	GoodQuality
CTTACCGTCCTTGGTC-1	GoodQuality
CTTACCGTCTTGACGA-1	GoodQuality
CTTAGGAAGAGCTTCT-1	LowQuality
CTTAGGAAGATATGGT-1	GoodQuality
CTTAGGAAGCGCTTAT-1	GoodQuality
CTTAGGAAGCTAAGAT-1	LowQuality
CTTAGGACAATAAGCA-1	LowQuality
CTTAGGACAGCTGCTG-1	GoodQuality
CTTAGGACAGTGGGAT-1	GoodQuality
CTTAGGAGTTGGAGGT-1	LowQuality
CTTAGGATCAAAGTAG-1	LowQuality
CTTAGGATCTCCCTGA-1	GoodQuality
CTTAGGATCTGCTGCT-1	GoodQuality
CTTAGGATCTGGTGTA-1	GoodQuality
CTTAGGATCTGTCTAT-1	GoodQuality
CTTCTCTAGATATGCA-1	LowQuality
CTTCTCTCACAAGCCC-1	LowQuality
CTTCTCTCACATCCAA-1	GoodQuality
CTTCTCTCAGTGGAGT-1	LowQuality
CTTCTCTGTACCCAAT-1	GoodQuality
CTTCTCTGTTCACCTC-1	LowQuality
CTTCTCTTCAGCTCGG-1	LowQuality
CTTCTCTTCAGCTGGC-1	LowQuality
CTTCTCTTCGTCACGG-1	GoodQuality
CTTGGCTAGATCCTGT-1	GoodQuality
CTTGGCTAGGCGATAC-1	GoodQuality
CTTGGCTAGGTCGGAT-1	GoodQuality
CTTGGCTAGTGACATA-1	GoodQuality
CTTGGCTAGTTAGCGG-1	GoodQuality
CTTGGCTCAAGCCGCT-1	LowQuality
CTTGGCTCAAGGTGTG-1	GoodQuality
CTTGGCTGTAGAGGAA-1	LowQuality
CTTGGCTGTATATCCG-1	LowQuality
CTTGGCTGTATATGGA-1	GoodQuality
CTTGGCTGTCGACTGC-1	GoodQuality
CTTGGCTGTGTAAGTA-1	LowQuality
CTTGGCTGTTTGACTG-1	GoodQuality
CTTGGCTTCATTGCCC-1	GoodQuality
CTTGGCTTCGGATGGA-1	GoodQuality
CTTGGCTTCGGTTAAC-1	GoodQuality
CTTGGCTTCTCTGAGA-1	LowQuality
CTTTGCGAGAGACGAA-1	GoodQuality
CTTTGCGAGCCCAATT-1	GoodQuality
CTTTGCGCATATACGC-1	LowQuality
CTTTGCGGTACAGCAG-1	GoodQuality
CTTTGCGGTATTCGTG-1	LowQuality
CTTTGCGGTCCCTTGT-1	LowQuality
CTTTGCGGTTAAAGTG-1	GoodQuality
CTTTGCGGTTAGTGGG-1	GoodQuality
CTTTGCGGTTCGCGAC-1	LowQuality
CTTTGCGTCATAAAGG-1	GoodQuality
CTTTGCGTCCACGTTC-1	GoodQuality
CTTTGCGTCCGCATAA-1	LowQuality
CTTTGCGTCCGCGTTT-1	GoodQuality
CTTTGCGTCTGGTATG-1	GoodQuality
GAAACTCAGAATTGTG-1	GoodQuality
GAAACTCAGGTAGCTG-1	LowQuality
GAAACTCAGGTGTTAA-1	LowQuality
GAAACTCAGTGCCAGA-1	LowQuality
GAAACTCCAGGAATGC-1	LowQuality
GAAACTCCATATACCG-1	GoodQuality
GAAACTCCATCCTAGA-1	GoodQuality
GAAACTCGTACCGCTG-1	LowQuality
GAAACTCGTCACTTCC-1	GoodQuality
GAAACTCGTGAGCGAT-1	GoodQuality
GAAACTCGTGGGTCAA-1	LowQuality
GAAACTCGTTCAGACT-1	GoodQuality
GAAACTCGTTCCACTC-1	GoodQuality
GAAACTCTCATGGTCA-1	GoodQuality
GAAATGAAGGCGACAT-1	GoodQuality
GAAATGAAGTCATGCT-1	GoodQuality
GAAATGACAAACGCGA-1	LowQuality
GAAATGACACAACGTT-1	GoodQuality
GAAATGACAGTGGGAT-1	GoodQuality
GAAATGACATCAGTAC-1	GoodQuality
GAAATGATCATCTGCC-1	GoodQuality
GAAATGATCCCAAGTA-1	GoodQuality
GAAATGATCTTTAGTC-1	LowQuality
GAACATCAGTAACCCT-1	GoodQuality
GAACATCAGTTAGGTA-1	LowQuality
GAACATCCAAGAGGCT-1	GoodQuality
GAACATCCAATAACGA-1	GoodQuality
GAACATCGTATGAAAC-1	GoodQuality
GAACATCGTGGTAACG-1	GoodQuality
GAACATCTCCTCAATT-1	GoodQuality
GAACATCTCTAACTGG-1	GoodQuality
GAACATCTCTCGATGA-1	GoodQuality
GAACATCTCTTAGCCC-1	GoodQuality
GAACATCTCTTGTCAT-1	LowQuality
GAACCTAAGAATCTCC-1	GoodQuality
GAACCTAAGATCGATA-1	LowQuality
GAACCTAAGCTCCTCT-1	LowQuality
GAACCTAAGCTGTTCA-1	LowQuality
GAACCTACACACCGAC-1	LowQuality
GAACCTAGTAAATGAC-1	GoodQuality
GAACCTAGTTTGGGCC-1	LowQuality
GAACGGAAGAATGTGT-1	LowQuality
GAACGGAAGACGACGT-1	LowQuality
GAACGGAAGGCGCTCT-1	GoodQuality
GAACGGACACCCAGTG-1	GoodQuality
GAACGGACATACTCTT-1	GoodQuality
GAACGGACATTAACCG-1	GoodQuality
GAACGGAGTCAAACTC-1	GoodQuality
GAACGGAGTCAGTGGA-1	GoodQuality
GAACGGAGTCCTAGCG-1	GoodQuality
GAACGGAGTCTAGCGC-1	LowQuality
GAACGGAGTCTAGTCA-1	LowQuality
GAACGGAGTTCTGTTT-1	GoodQuality
GAACGGATCCTGTACC-1	GoodQuality
GAACGGATCTTTCCTC-1	GoodQuality
GAAGCAGAGACGACGT-1	LowQuality
GAAGCAGAGCCACCTG-1	GoodQuality
GAAGCAGAGCCCGAAA-1	GoodQuality
GAAGCAGAGTGGGCTA-1	GoodQuality
GAAGCAGCAACAACCT-1	GoodQuality
GAAGCAGGTACACCGC-1	GoodQuality
GAAGCAGGTACGAAAT-1	GoodQuality
GAAGCAGGTCGAACAG-1	GoodQuality
GAAGCAGGTGATGTCT-1	GoodQuality
GAAGCAGGTGCTTCTC-1	GoodQuality
GAAGCAGGTTCGGCAC-1	GoodQuality
GAAGCAGGTTCGGGCT-1	LowQuality
GAAGCAGTCCACTCCA-1	GoodQuality
GAATAAGAGCACAGGT-1	GoodQuality
GAATAAGAGGCCATAG-1	GoodQuality
GAATAAGAGTACTTGC-1	LowQuality
GAATAAGAGTCCAGGA-1	GoodQuality
GAATAAGAGTGTCCCG-1	GoodQuality
GAATAAGCACATCCAA-1	GoodQuality
GAATAAGCACTTAACG-1	GoodQuality
GAATAAGGTTACGTCA-1	GoodQuality
GAATAAGGTTCGGCAC-1	GoodQuality
GAATAAGTCAACACTG-1	GoodQuality
GAATAAGTCAATCTCT-1	GoodQuality
GAATAAGTCCCTGACT-1	LowQuality
GAATGAAAGCCGGTAA-1	GoodQuality
GAATGAAAGGACTGGT-1	LowQuality
GAATGAAAGGCGACAT-1	LowQuality
GAATGAACAATCACAC-1	GoodQuality
GAATGAACACGTGAGA-1	LowQuality
GAATGAACATTCTTAC-1	LowQuality
GAATGAAGTACGAAAT-1	GoodQuality
GAATGAAGTCAAACTC-1	LowQuality
GAATGAAGTCCGAAGA-1	GoodQuality
GAATGAAGTTGATTGC-1	GoodQuality
GAATGAATCTCCAGGG-1	GoodQuality
GACACGCAGGCTAGAC-1	GoodQuality
GACACGCAGGGTGTGT-1	LowQuality
GACACGCAGTATCTCG-1	LowQuality
GACACGCAGTGGACGT-1	GoodQuality
GACACGCAGTGTGAAT-1	GoodQuality
GACACGCCAAAGGAAG-1	LowQuality
GACACGCCACATCTTT-1	LowQuality
GACACGCCAGACGCAA-1	LowQuality
GACACGCCAGGGTACA-1	GoodQuality
GACACGCCATGCGCAC-1	GoodQuality
GACACGCGTACTCAAC-1	GoodQuality
GACACGCGTAGGCATG-1	GoodQuality
GACACGCTCCTGCTTG-1	LowQuality
GACACGCTCGCATGAT-1	LowQuality
GACAGAGAGGCCCTCA-1	GoodQuality
GACAGAGAGGCTCATT-1	GoodQuality
GACAGAGCACCTCGTT-1	LowQuality
GACAGAGCAGTAAGCG-1	GoodQuality
GACAGAGCAGTTCCCT-1	GoodQuality
GACAGAGCATTGGCGC-1	GoodQuality
GACAGAGGTCCGAAGA-1	LowQuality
GACAGAGGTCGAGTTT-1	GoodQuality
GACAGAGGTTAAGGGC-1	GoodQuality
GACAGAGGTTATGTGC-1	GoodQuality
GACAGAGGTTGCTCCT-1	GoodQuality
GACAGAGTCAGCATGT-1	GoodQuality
GACAGAGTCTCCAACC-1	GoodQuality
GACAGAGTCTCCGGTT-1	LowQuality
GACAGAGTCTGAAAGA-1	GoodQuality
GACCAATAGCTCCTCT-1	GoodQuality
GACCAATAGGAGTTGC-1	LowQuality
GACCAATAGGAGTTTA-1	GoodQuality
GACCAATAGTATCTCG-1	LowQuality
GACCAATCAGAAGCAC-1	LowQuality
GACCAATCAGCCTTTC-1	GoodQuality
GACCAATCAGTCGATT-1	LowQuality
GACCAATCATACAGCT-1	LowQuality
GACCAATGTACCGAGA-1	LowQuality
GACCAATTCGGCGGTT-1	GoodQuality
GACCTGGAGAGAACAG-1	GoodQuality
GACCTGGAGAGACGAA-1	GoodQuality
GACCTGGAGGATGTAT-1	GoodQuality
GACCTGGAGTTCGCGC-1	LowQuality
GACCTGGCAACGCACC-1	LowQuality
GACCTGGCAACTGGCC-1	GoodQuality
GACCTGGCAGACGCAA-1	LowQuality
GACCTGGCAGGCAGTA-1	LowQuality
GACCTGGTCCCATTAT-1	GoodQuality
GACCTGGTCCCGACTT-1	LowQuality
GACCTGGTCCGCAAGC-1	GoodQuality
GACCTGGTCTGGCGAC-1	GoodQuality
GACGCGTAGAAAGTGG-1	LowQuality
GACGCGTAGAAGGTGA-1	GoodQuality
GACGCGTAGCATGGCA-1	LowQuality
GACGCGTAGCTTTGGT-1	GoodQuality
GACGCGTAGGACGAAA-1	GoodQuality
GACGCGTCAAAGCGGT-1	LowQuality
GACGCGTCACCAGTTA-1	GoodQuality
GACGCGTCAGTGACAG-1	GoodQuality
GACGCGTCATGGAATA-1	LowQuality
GACGCGTCATGGGAAC-1	GoodQuality
GACGCGTGTCGCATAT-1	LowQuality
GACGCGTGTTCGTGAT-1	GoodQuality
GACGCGTGTTGGACCC-1	GoodQuality
GACGCGTTCGCTAGCG-1	GoodQuality
GACGCGTTCGTCTGCT-1	GoodQuality
GACGGCTAGACTCGGA-1	GoodQuality
GACGGCTCACACCGCA-1	GoodQuality
GACGGCTCACATCCAA-1	GoodQuality
GACGGCTCAGAGTGTG-1	LowQuality
GACGGCTCAGCTCGAC-1	LowQuality
GACGGCTCAGCTGTGC-1	GoodQuality
GACGGCTCAGTAAGCG-1	GoodQuality
GACGGCTCATCGATGT-1	LowQuality
GACGGCTCATGGTAGG-1	GoodQuality
GACGGCTGTAAACACA-1	GoodQuality
GACGGCTGTATCAGTC-1	GoodQuality
GACGGCTGTCTTGATG-1	GoodQuality
GACGGCTGTGAGGCTA-1	GoodQuality
GACGGCTGTTCCCGAG-1	LowQuality
GACGGCTGTTGTCGCG-1	LowQuality
GACGGCTTCAAACGGG-1	LowQuality
GACGGCTTCCCGGATG-1	GoodQuality
GACGGCTTCCTAGAAC-1	GoodQuality
GACGGCTTCGCCCTTA-1	GoodQuality
GACGGCTTCGTCTGCT-1	GoodQuality
GACGGCTTCTCGCTTG-1	GoodQuality
GACGGCTTCTGTGCAA-1	GoodQuality
GACGTGCAGGATGGTC-1	GoodQuality
GACGTGCCACATGTGT-1	LowQuality
GACGTGCCAGAAGCAC-1	GoodQuality
GACGTGCCAGAGCCAA-1	LowQuality
GACGTGCCAGCGTTCG-1	GoodQuality
GACGTGCCAGTATGCT-1	LowQuality
GACGTGCCATACTACG-1	GoodQuality
GACGTGCCATCACGTA-1	GoodQuality
GACGTGCGTATTAGCC-1	GoodQuality
GACGTGCGTCACACGC-1	GoodQuality
GACGTGCGTGAGCGAT-1	GoodQuality
GACGTGCTCAATAAGG-1	GoodQuality
GACGTGCTCACTCCTG-1	GoodQuality
GACGTGCTCAGGTTCA-1	GoodQuality
GACGTGCTCCAGATCA-1	LowQuality
GACGTTAAGCTTTGGT-1	GoodQuality
GACGTTAAGGTAAACT-1	GoodQuality
GACGTTAAGTGGGTTG-1	GoodQuality
GACGTTACAATGTAAG-1	GoodQuality
GACGTTACACGTGAGA-1	GoodQuality
GACGTTACAGCCAGAA-1	GoodQuality
GACGTTAGTCTCTTTA-1	GoodQuality
GACGTTATCAGATAAG-1	LowQuality
GACGTTATCATCTGTT-1	LowQuality
GACGTTATCCACGCAG-1	GoodQuality
GACGTTATCCGGGTGT-1	GoodQuality
GACGTTATCGGCGCAT-1	LowQuality
GACTAACCAAGTACCT-1	GoodQuality
GACTAACCAATCCGAT-1	LowQuality
GACTAACCAATCTACG-1	GoodQuality
GACTAACCACCAACCG-1	GoodQuality
GACTAACCATAAAGGT-1	GoodQuality
GACTAACCATCACCCT-1	GoodQuality
GACTAACCATGGGACA-1	GoodQuality
GACTAACCATTTCAGG-1	GoodQuality
GACTAACGTAAATGAC-1	GoodQuality
GACTAACGTACCGCTG-1	LowQuality
GACTAACGTCGAAAGC-1	LowQuality
GACTAACGTGATGTCT-1	GoodQuality
GACTAACGTTCGTTGA-1	LowQuality
GACTAACTCCAGAGGA-1	LowQuality
GACTAACTCCCAAGTA-1	GoodQuality
GACTAACTCCGAATGT-1	LowQuality
GACTAACTCCTGTACC-1	LowQuality
GACTAACTCGCAGGCT-1	GoodQuality
GACTAACTCGCATGAT-1	GoodQuality
GACTACAAGACAGACC-1	LowQuality
GACTACACAATAAGCA-1	GoodQuality
GACTACAGTCGAACAG-1	GoodQuality
GACTGCGAGAGCTATA-1	GoodQuality
GACTGCGAGGCCGAAT-1	GoodQuality
GACTGCGAGGCTATCT-1	GoodQuality
GACTGCGAGTCGTTTG-1	GoodQuality
GACTGCGCAAAGGCGT-1	LowQuality
GACTGCGCACCACGTG-1	GoodQuality
GACTGCGCAGTATGCT-1	LowQuality
GACTGCGGTCTAGCGC-1	LowQuality
GACTGCGTCACCAGGC-1	GoodQuality
GACTGCGTCAGGCAAG-1	LowQuality
GACTGCGTCAGTCAGT-1	LowQuality
GACTGCGTCAGTTTGG-1	GoodQuality
GACTGCGTCGTCGTTC-1	GoodQuality
GAGCAGAAGATGGGTC-1	GoodQuality
GAGCAGAAGCGTTTAC-1	LowQuality
GAGCAGAAGGATGTAT-1	GoodQuality
GAGCAGAAGGTGACCA-1	GoodQuality
GAGCAGAAGTCGATAA-1	LowQuality
GAGCAGACAGACACTT-1	GoodQuality
GAGCAGACATGCTGGC-1	LowQuality
GAGCAGAGTACATGTC-1	GoodQuality
GAGCAGAGTCGAATCT-1	GoodQuality
GAGCAGAGTTACGACT-1	GoodQuality
GAGCAGATCACCGTAA-1	GoodQuality
GAGCAGATCGGTTCGG-1	GoodQuality
GAGCAGATCTCAAACG-1	GoodQuality
GAGGTGAAGTGACTCT-1	GoodQuality
GAGGTGACAAGAAAGG-1	GoodQuality
GAGGTGACAATGGAGC-1	LowQuality
GAGGTGACAGATCCAT-1	GoodQuality
GAGGTGAGTAAGGATT-1	LowQuality
GAGGTGAGTAGTGAAT-1	GoodQuality
GAGGTGAGTCAGAATA-1	GoodQuality
GAGGTGAGTCAGGACA-1	GoodQuality
GAGGTGAGTCGGCACT-1	GoodQuality
GAGGTGAGTGTATGGG-1	GoodQuality
GAGGTGATCCATGAGT-1	GoodQuality
GAGGTGATCCTTCAAT-1	GoodQuality
GAGTCCGAGACTGGGT-1	GoodQuality
GAGTCCGAGCTAGCCC-1	GoodQuality
GAGTCCGAGGCAATTA-1	GoodQuality
GAGTCCGAGTACCGGA-1	GoodQuality
GAGTCCGCAAGTTCTG-1	GoodQuality
GAGTCCGCAATGAAAC-1	GoodQuality
GAGTCCGCACTGTGTA-1	LowQuality
GAGTCCGCAGTTTACG-1	LowQuality
GAGTCCGCATTGCGGC-1	GoodQuality
GAGTCCGGTCAACTGT-1	GoodQuality
GAGTCCGTCCTAAGTG-1	GoodQuality
GAGTCCGTCGGCGCAT-1	LowQuality
GAGTCCGTCTGTGCAA-1	GoodQuality
GATCAGTAGCAACGGT-1	GoodQuality
GATCAGTCAAGGACTG-1	GoodQuality
GATCAGTCACCAACCG-1	LowQuality
GATCAGTCAGCTGCAC-1	GoodQuality
GATCAGTCAGGTCGTC-1	GoodQuality
GATCAGTCATGTCCTC-1	GoodQuality
GATCAGTGTCACAAGG-1	GoodQuality
GATCAGTGTCACCTAA-1	LowQuality
GATCAGTTCCGTAGGC-1	LowQuality
GATCGATAGAGCTATA-1	LowQuality
GATCGATCACGGTGTC-1	GoodQuality
GATCGATCATCGGAAG-1	GoodQuality
GATCGATGTCAAAGAT-1	LowQuality
GATCGATGTCTCCCTA-1	GoodQuality
GATCGATTCTATCCCG-1	GoodQuality
GATCGCGAGCGATTCT-1	GoodQuality
GATCGCGAGGACTGGT-1	GoodQuality
GATCGCGAGTTGCAGG-1	GoodQuality
GATCGCGCACCATCCT-1	GoodQuality
GATCGCGCATGCATGT-1	GoodQuality
GATCGCGGTAATTGGA-1	LowQuality
GATCGCGGTATTCTCT-1	GoodQuality
GATCGCGGTCTCCCTA-1	GoodQuality
GATCGCGGTGCGCTTG-1	GoodQuality
GATCGCGGTTATGTGC-1	GoodQuality
GATCGCGTCAACCAAC-1	GoodQuality
GATCGCGTCACGAAGG-1	GoodQuality
GATCGCGTCAGTCCCT-1	GoodQuality
GATCGCGTCGTGGACC-1	LowQuality
GATCGTAAGAACAATC-1	GoodQuality
GATCGTAAGATACACA-1	LowQuality
GATCGTAAGGGATGGG-1	LowQuality
GATCGTAAGTACGATA-1	GoodQuality
GATCGTAAGTACGTAA-1	GoodQuality
GATCGTACAAACCCAT-1	GoodQuality
GATCGTACACCGAAAG-1	GoodQuality
GATCGTACAGCGATCC-1	GoodQuality
GATCGTACATCGGAAG-1	GoodQuality
GATCGTAGTCAGAATA-1	LowQuality
GATCGTAGTCTCACCT-1	GoodQuality
GATCGTAGTTATGCGT-1	GoodQuality
GATCGTAGTTGAGGTG-1	LowQuality
GATCGTATCACCTCGT-1	GoodQuality
GATCGTATCAGGCGAA-1	GoodQuality
GATCGTATCCTTAATC-1	GoodQuality
GATCTAGAGAACAATC-1	LowQuality
GATCTAGAGATAGTCA-1	GoodQuality
GATCTAGAGCAGACTG-1	LowQuality
GATCTAGAGCTGTTCA-1	GoodQuality
GATCTAGAGTGGCACA-1	GoodQuality
GATCTAGAGTGGTAGC-1	GoodQuality
GATCTAGCAAACAACA-1	GoodQuality
GATCTAGCAAGTCATC-1	GoodQuality
GATCTAGCATCCGGGT-1	LowQuality
GATCTAGCATTATCTC-1	GoodQuality
GATCTAGGTAATCACC-1	LowQuality
GATCTAGGTCCATGAT-1	GoodQuality
GATCTAGTCGTAGGAG-1	GoodQuality
GATGAAAAGCTGAACG-1	GoodQuality
GATGAAAAGTACCGGA-1	GoodQuality
GATGAAAAGTACTTGC-1	GoodQuality
GATGAAAAGTGGACGT-1	GoodQuality
GATGAAACAATGGTCT-1	LowQuality
GATGAAACAGCCTTGG-1	LowQuality
GATGAAACATCACGTA-1	GoodQuality
GATGAAAGTAAATGTG-1	LowQuality
GATGAAAGTCAGTGGA-1	GoodQuality
GATGAAAGTTATCACG-1	GoodQuality
GATGAAATCATCGATG-1	GoodQuality
GATGAAATCCACGACG-1	LowQuality
GATGAAATCGAACGGA-1	GoodQuality
GATGAGGAGATGGGTC-1	GoodQuality
GATGAGGAGGACATTA-1	GoodQuality
GATGAGGAGGTAGCTG-1	GoodQuality
GATGAGGAGTTGAGAT-1	GoodQuality
GATGAGGCACACATGT-1	GoodQuality
GATGAGGCACCAGGTC-1	LowQuality
GATGAGGCACGACTCG-1	GoodQuality
GATGAGGCAGCCTTGG-1	LowQuality
GATGAGGCAGTTTACG-1	GoodQuality
GATGAGGCATGTTGAC-1	GoodQuality
GATGAGGGTCCAACTA-1	LowQuality
GATGAGGGTGAGGCTA-1	GoodQuality
GATGAGGGTTAAGTAG-1	GoodQuality
GATGAGGGTTATGTGC-1	GoodQuality
GATGCTAAGCGATGAC-1	GoodQuality
GATGCTAAGGCTCTTA-1	GoodQuality
GATGCTAAGTCGATAA-1	GoodQuality
GATGCTAAGTGGGATC-1	GoodQuality
GATGCTACAGGATCGA-1	LowQuality
GATGCTACATAGAAAC-1	LowQuality
GATGCTACATAGGATA-1	GoodQuality
GATGCTAGTCAACATC-1	GoodQuality
GATGCTAGTCTCCACT-1	GoodQuality
GATGCTAGTCTGGAGA-1	GoodQuality
GATGCTATCAACCAAC-1	GoodQuality
GATGCTATCAGCCTAA-1	LowQuality
GATGCTATCCTCAACC-1	GoodQuality
GATGCTATCTGAGGGA-1	GoodQuality
GATTCAGAGAGAACAG-1	LowQuality
GATTCAGAGAGGTAGA-1	GoodQuality
GATTCAGAGATCCCGC-1	LowQuality
GATTCAGAGCGCTTAT-1	LowQuality
GATTCAGAGTCCGGTC-1	GoodQuality
GATTCAGAGTCCGTAT-1	GoodQuality
GATTCAGCAAGCGTAG-1	GoodQuality
GATTCAGCACCGTTGG-1	GoodQuality
GATTCAGCAGACAAGC-1	GoodQuality
GATTCAGCAGACTCGC-1	GoodQuality
GATTCAGCAGTCAGAG-1	LowQuality
GATTCAGGTCCCTTGT-1	GoodQuality
GATTCAGGTTAAGATG-1	LowQuality
GATTCAGTCAGTCCCT-1	GoodQuality
GATTCAGTCCGTAGTA-1	GoodQuality
GATTCAGTCCTGCCAT-1	GoodQuality
GCAAACTAGATATACG-1	LowQuality
GCAAACTAGATATGCA-1	GoodQuality
GCAAACTAGTGCAAGC-1	GoodQuality
GCAAACTAGTTAGCGG-1	GoodQuality
GCAAACTCACATTAGC-1	GoodQuality
GCAAACTCACCGGAAA-1	GoodQuality
GCAAACTCAGCGTTCG-1	GoodQuality
GCAAACTCATTTCACT-1	GoodQuality
GCAAACTGTCTGCCAG-1	GoodQuality
GCAAACTGTTCCACGG-1	GoodQuality
GCAAACTTCACGACTA-1	GoodQuality
GCAAACTTCCCTAATT-1	LowQuality
GCAATCACATACTACG-1	GoodQuality
GCAATCAGTTAAGTAG-1	LowQuality
GCAATCATCATTATCC-1	LowQuality
GCAATCATCCGCATAA-1	GoodQuality
GCAATCATCGGTCTAA-1	GoodQuality
GCAATCATCTCAAGTG-1	GoodQuality
GCACATACATGTTCCC-1	GoodQuality
GCACATAGTAGCTTGT-1	GoodQuality
GCACATAGTGCTTCTC-1	GoodQuality
GCACATATCATGTCCC-1	GoodQuality
GCACATATCCTACAGA-1	LowQuality
GCACATATCCTGCAGG-1	GoodQuality
GCACATATCTATCGCC-1	GoodQuality
GCACATATCTCATTCA-1	GoodQuality
GCACTCTAGAAACCAT-1	LowQuality
GCACTCTAGACTTGAA-1	LowQuality
GCACTCTAGTGCCAGA-1	GoodQuality
GCACTCTAGTGGACGT-1	LowQuality
GCACTCTCACCACGTG-1	LowQuality
GCACTCTCACCAGCAC-1	GoodQuality
GCACTCTGTACCGTTA-1	GoodQuality
GCACTCTGTCATCGGC-1	LowQuality
GCACTCTGTTAAAGAC-1	GoodQuality
GCACTCTTCAGCAACT-1	GoodQuality
GCACTCTTCATGTAGC-1	GoodQuality
GCACTCTTCATGTCCC-1	GoodQuality
GCACTCTTCCGTTGTC-1	GoodQuality
GCAGCCAAGAGCAATT-1	LowQuality
GCAGCCAAGCGAGAAA-1	GoodQuality
GCAGCCAAGCTGTCTA-1	GoodQuality
GCAGCCAAGCTTTGGT-1	LowQuality
GCAGCCAAGGACGAAA-1	GoodQuality
GCAGCCAAGTACGCGA-1	GoodQuality
GCAGCCAAGTGTGAAT-1	GoodQuality
GCAGCCACACACAGAG-1	GoodQuality
GCAGCCACACCCATTC-1	LowQuality
GCAGCCACACTTCTGC-1	GoodQuality
GCAGCCAGTAATTGGA-1	GoodQuality
GCAGCCAGTAGGACAC-1	LowQuality
GCAGCCAGTATCGCAT-1	GoodQuality
GCAGCCATCACATGCA-1	LowQuality
GCAGCCATCATGCTCC-1	GoodQuality
GCAGTTAAGTACGCGA-1	GoodQuality
GCAGTTAAGTCTCGGC-1	LowQuality
GCAGTTAAGTGGAGAA-1	LowQuality
GCAGTTACAATGAATG-1	LowQuality
GCAGTTACAGCGTAAG-1	GoodQuality
GCAGTTACAGGTGCCT-1	GoodQuality
GCAGTTACATGTAGTC-1	LowQuality
GCAGTTAGTCACCTAA-1	LowQuality
GCAGTTAGTGACTACT-1	LowQuality
GCAGTTAGTTTGGCGC-1	GoodQuality
GCAGTTATCTGCTGCT-1	GoodQuality
GCAGTTATCTGGGCCA-1	GoodQuality
GCATACAAGACTAAGT-1	GoodQuality
GCATACAAGGACATTA-1	GoodQuality
GCATACACAATGAATG-1	GoodQuality
GCATACACACGCATCG-1	GoodQuality
GCATACACACTGTCGG-1	GoodQuality
GCATACACAGACGCTC-1	GoodQuality
GCATACACATAGGATA-1	GoodQuality
GCATACAGTTACGGAG-1	LowQuality
GCATACATCAGCTGGC-1	GoodQuality
GCATACATCGGATGTT-1	LowQuality
GCATACATCGTTACAG-1	GoodQuality
GCATACATCTCTGAGA-1	LowQuality
GCATACATCTCTTGAT-1	GoodQuality
GCATACATCTGGTTCC-1	LowQuality
GCATGATCACACGCTG-1	LowQuality
GCATGATCAGACGCCT-1	GoodQuality
GCATGATCAGCTGTGC-1	LowQuality
GCATGATCATGCGCAC-1	LowQuality
GCATGATGTCAACATC-1	LowQuality
GCATGATGTCTAACGT-1	LowQuality
GCATGATGTTCGTTGA-1	GoodQuality
GCATGATTCATGTGGT-1	GoodQuality
GCATGATTCCAATGGT-1	GoodQuality
GCATGATTCCTGCAGG-1	GoodQuality
GCATGATTCGAGAACG-1	GoodQuality
GCATGATTCGGCGCTA-1	GoodQuality
GCATGATTCGGTGTTA-1	GoodQuality
GCATGCGAGACAAAGG-1	GoodQuality
GCATGCGCAGATGAGC-1	GoodQuality
GCATGCGCAGCGTTCG-1	GoodQuality
GCATGCGCATAAAGGT-1	GoodQuality
GCATGCGCATATACGC-1	GoodQuality
GCATGCGGTCAGATAA-1	GoodQuality
GCATGCGGTCATACTG-1	GoodQuality
GCATGCGGTGAGGGTT-1	GoodQuality
GCATGCGGTTTGGCGC-1	GoodQuality
GCATGCGTCCGAATGT-1	LowQuality
GCATGTAAGTATGACA-1	GoodQuality
GCATGTACAAACTGCT-1	LowQuality
GCATGTACAATGCCAT-1	GoodQuality
GCATGTACACAGACAG-1	LowQuality
GCATGTACAGTGAGTG-1	GoodQuality
GCATGTACAGTTCATG-1	GoodQuality
GCATGTAGTCCGCTGA-1	LowQuality
GCATGTAGTGTGTGCC-1	LowQuality
GCATGTAGTTCGTGAT-1	GoodQuality
GCATGTAGTTTGTTTC-1	GoodQuality
GCATGTATCATAAAGG-1	LowQuality
GCATGTATCCTTGGTC-1	GoodQuality
GCATGTATCTGGTATG-1	LowQuality
GCCAAATAGGAGTACC-1	GoodQuality
GCCAAATAGGGAACGG-1	GoodQuality
GCCAAATGTAAGTAGT-1	LowQuality
GCCAAATGTGTCGCTG-1	LowQuality
GCCAAATGTGTGACGA-1	LowQuality
GCCAAATTCAACGGCC-1	GoodQuality
GCCTCTAAGAGTGAGA-1	GoodQuality
GCCTCTAAGTTATCGC-1	GoodQuality
GCCTCTACATGAAGTA-1	GoodQuality
GCCTCTAGTGCGGTAA-1	GoodQuality
GCGACCAAGTTAAGTG-1	GoodQuality
GCGACCAAGTTCGCGC-1	GoodQuality
GCGACCACAATCGAAA-1	GoodQuality
GCGACCACAGGAATCG-1	GoodQuality
GCGACCACATAGAAAC-1	GoodQuality
GCGACCAGTAAGTGTA-1	GoodQuality
GCGACCAGTAGCGCAA-1	LowQuality
GCGACCAGTAGTAGTA-1	GoodQuality
GCGACCAGTCCTCCAT-1	LowQuality
GCGACCAGTCTCGTTC-1	GoodQuality
GCGACCATCATGCTCC-1	GoodQuality
GCGACCATCCTATGTT-1	GoodQuality
GCGACCATCCTCAATT-1	GoodQuality
GCGACCATCGGTTAAC-1	GoodQuality
GCGACCATCTGCAAGT-1	GoodQuality
GCGAGAACATAGAAAC-1	GoodQuality
GCGAGAACATCACGAT-1	GoodQuality
GCGAGAACATCCAACA-1	GoodQuality
GCGAGAACATGAAGTA-1	GoodQuality
GCGAGAACATTGCGGC-1	GoodQuality
GCGAGAAGTGACCAAG-1	LowQuality
GCGAGAATCGTAGGTT-1	GoodQuality
GCGAGAATCTAGCACA-1	LowQuality
GCGAGAATCTTGTATC-1	LowQuality
GCGCAACAGCGTCAAG-1	LowQuality
GCGCAACAGTCGATAA-1	GoodQuality
GCGCAACAGTTAGGTA-1	GoodQuality
GCGCAACCAGATCCAT-1	GoodQuality
GCGCAACCAGCCACCA-1	GoodQuality
GCGCAACCATTAACCG-1	GoodQuality
GCGCAACGTGTCAATC-1	GoodQuality
GCGCAACGTTCATGGT-1	GoodQuality
GCGCAACGTTCTCATT-1	GoodQuality
GCGCAACTCAAGAAGT-1	GoodQuality
GCGCAACTCAGTCAGT-1	LowQuality
GCGCAACTCATACGGT-1	LowQuality
GCGCAACTCCAACCAA-1	GoodQuality
GCGCAACTCCCATTAT-1	GoodQuality
GCGCAACTCGAATCCA-1	GoodQuality
GCGCAGTAGGGAAACA-1	GoodQuality
GCGCAGTCAATAGAGT-1	LowQuality
GCGCAGTCACATGACT-1	GoodQuality
GCGCAGTCAGATAATG-1	LowQuality
GCGCAGTGTCAAGCGA-1	LowQuality
GCGCAGTGTCGAGTTT-1	LowQuality
GCGCAGTGTTGAGGTG-1	GoodQuality
GCGCAGTTCAGGTAAA-1	GoodQuality
GCGCAGTTCATCATTC-1	GoodQuality
GCGCAGTTCATCGGAT-1	GoodQuality
GCGCAGTTCCCGACTT-1	GoodQuality
GCGCAGTTCTTACCTA-1	LowQuality
GCGCCAAAGGATATAC-1	LowQuality
GCGCCAAAGGCGTACA-1	LowQuality
GCGCCAAAGTGGTAAT-1	GoodQuality
GCGCCAACAACACCTA-1	LowQuality
GCGCCAACAACCGCCA-1	GoodQuality
GCGCCAACACCACCAG-1	GoodQuality
GCGCCAACACTCTGTC-1	GoodQuality
GCGCCAACAGTAAGCG-1	GoodQuality
GCGCCAAGTAACGACG-1	GoodQuality
GCGCCAAGTAGGGACT-1	GoodQuality
GCGCCAAGTCAATGTC-1	GoodQuality
GCGCCAAGTCACAAGG-1	GoodQuality
GCGCCAAGTCAGAGGT-1	GoodQuality
GCGCCAAGTCGGGTCT-1	LowQuality
GCGCCAATCAAACCAC-1	GoodQuality
GCGCCAATCACGAAGG-1	GoodQuality
GCGCCAATCATTCACT-1	GoodQuality
GCGCCAATCCCAAGTA-1	LowQuality
GCGCCAATCCCTGACT-1	LowQuality
GCGCCAATCCCTTGCA-1	GoodQuality
GCGCCAATCCGCATCT-1	GoodQuality
GCGCCAATCGAACGGA-1	GoodQuality
GCGCGATAGATATGCA-1	LowQuality
GCGCGATAGTTGTCGT-1	GoodQuality
GCGCGATCAAGCCATT-1	GoodQuality
GCGCGATCAATGACCT-1	LowQuality
GCGCGATCACCCATTC-1	LowQuality
GCGCGATCAGATCGGA-1	GoodQuality
GCGCGATGTAGCCTCG-1	GoodQuality
GCGCGATGTGCACGAA-1	GoodQuality
GCGCGATGTTAGGGTG-1	LowQuality
GCGCGATGTTGCTCCT-1	LowQuality
GCGGGTTAGCCTTGAT-1	GoodQuality
GCGGGTTAGCGCCTTG-1	GoodQuality
GCGGGTTAGGACAGCT-1	GoodQuality
GCGGGTTCAAGAAGAG-1	GoodQuality
GCGGGTTCAAGGGTCA-1	GoodQuality
GCGGGTTGTACTCTCC-1	GoodQuality
GCGGGTTGTCAGTGGA-1	GoodQuality
GCGGGTTGTGAAATCA-1	LowQuality
GCGGGTTTCACGCGGT-1	GoodQuality
GCTCCTAAGCGAAGGG-1	GoodQuality
GCTCCTAAGTCGCCGT-1	GoodQuality
GCTCCTAAGTGGTAGC-1	GoodQuality
GCTCCTAAGTGTTAGA-1	GoodQuality
GCTCCTACACACGCTG-1	GoodQuality
GCTCCTACACTTCTGC-1	GoodQuality
GCTCCTACAGGGTATG-1	LowQuality
GCTCCTAGTAGCCTCG-1	LowQuality
GCTCCTAGTCACCCAG-1	GoodQuality
GCTCCTAGTCCGTCAG-1	GoodQuality
GCTCCTAGTCGTTGTA-1	GoodQuality
GCTCCTATCCATTCTA-1	GoodQuality
GCTCCTATCGGGAGTA-1	LowQuality
GCTCTGTAGAAACGAG-1	LowQuality
GCTCTGTAGTCCCACG-1	LowQuality
GCTCTGTCAAACTGTC-1	GoodQuality
GCTCTGTCAAGCTGGA-1	LowQuality
GCTCTGTCAATGAATG-1	LowQuality
GCTCTGTCACGGTAAG-1	GoodQuality
GCTCTGTGTCCGAGTC-1	LowQuality
GCTCTGTTCGCTTAGA-1	GoodQuality
GCTCTGTTCTGAGGGA-1	GoodQuality
GCTCTGTTCTGATACG-1	GoodQuality
GCTGCAGAGAGGGCTT-1	LowQuality
GCTGCAGAGTCTCCTC-1	GoodQuality
GCTGCAGAGTTACCCA-1	GoodQuality
GCTGCAGAGTTGAGTA-1	LowQuality
GCTGCAGCAGCAGTTT-1	GoodQuality
GCTGCAGCAGGTCGTC-1	GoodQuality
GCTGCAGCAGTTCCCT-1	GoodQuality
GCTGCAGCATCTCCCA-1	LowQuality
GCTGCAGGTGCAACGA-1	GoodQuality
GCTGCAGGTGGTCCGT-1	GoodQuality
GCTGCAGGTGGTTTCA-1	GoodQuality
GCTGCAGTCAGTGTTG-1	GoodQuality
GCTGCAGTCTGCGTAA-1	LowQuality
GCTGCGAAGTAGGCCA-1	GoodQuality
GCTGCGACAAAGCGGT-1	GoodQuality
GCTGCGACAATGTAAG-1	GoodQuality
GCTGCGACACGAAAGC-1	LowQuality
GCTGCGACACGGCTAC-1	GoodQuality
GCTGCGAGTTACGGAG-1	LowQuality
GCTGCGATCCTTTCTC-1	LowQuality
GCTGCGATCTTCATGT-1	GoodQuality
GCTGCTTAGGACAGCT-1	LowQuality
GCTGCTTAGGAGTCTG-1	GoodQuality
GCTGCTTAGGCTCAGA-1	GoodQuality
GCTGCTTCAACGATGG-1	GoodQuality
GCTGCTTCAATACGCT-1	GoodQuality
GCTGCTTCAGCCACCA-1	LowQuality
GCTGCTTGTCTCCATC-1	GoodQuality
GCTGCTTTCTCATTCA-1	LowQuality
GCTGGGTAGAAGGCCT-1	GoodQuality
GCTGGGTAGACAAAGG-1	GoodQuality
GCTGGGTAGATAGGAG-1	GoodQuality
GCTGGGTAGATTACCC-1	GoodQuality
GCTGGGTAGCGTGTCC-1	GoodQuality
GCTGGGTCACACCGAC-1	GoodQuality
GCTGGGTCACGACTCG-1	GoodQuality
GCTGGGTCACGGCGTT-1	GoodQuality
GCTGGGTCAGGCTGAA-1	GoodQuality
GCTGGGTCAGGGTTAG-1	GoodQuality
GCTGGGTCATGAGCGA-1	LowQuality
GCTGGGTCATGGGACA-1	GoodQuality
GCTGGGTGTAAACACA-1	GoodQuality
GCTGGGTGTACAAGTA-1	GoodQuality
GCTGGGTGTACGCTGC-1	GoodQuality
GCTGGGTGTATGAATG-1	GoodQuality
GCTGGGTGTCATACTG-1	GoodQuality
GCTGGGTGTTCATGGT-1	GoodQuality
GCTGGGTTCAGTTTGG-1	GoodQuality
GCTGGGTTCGGTGTTA-1	LowQuality
GCTGGGTTCGTATCAG-1	GoodQuality
GCTGGGTTCTGATTCT-1	GoodQuality
GCTTCCAAGAGATGAG-1	LowQuality
GCTTCCAAGATCCGAG-1	GoodQuality
GCTTCCAAGCAGGCTA-1	GoodQuality
GCTTCCAAGCTCCTCT-1	GoodQuality
GCTTCCACAAAGCAAT-1	LowQuality
GCTTCCACAATAAGCA-1	GoodQuality
GCTTCCACAATGGATA-1	GoodQuality
GCTTCCACACAACTGT-1	GoodQuality
GCTTCCACATACGCTA-1	GoodQuality
GCTTCCACATGGTCTA-1	GoodQuality
GCTTCCAGTAATAGCA-1	GoodQuality
GCTTCCAGTAGGCTGA-1	GoodQuality
GCTTCCAGTCCCTTGT-1	GoodQuality
GCTTCCAGTGTAATGA-1	GoodQuality
GCTTCCAGTTCAGACT-1	GoodQuality
GCTTCCATCAGCTTAG-1	GoodQuality
GCTTCCATCAGTTTGG-1	GoodQuality
GCTTCCATCGAGAGCA-1	GoodQuality
GCTTCCATCGCCAGCA-1	GoodQuality
GCTTGAAAGACGACGT-1	LowQuality
GCTTGAAAGAGGTACC-1	GoodQuality
GCTTGAAAGGAATCGC-1	GoodQuality
GCTTGAAAGTGCGTGA-1	GoodQuality
GCTTGAACACAGCGTC-1	LowQuality
GCTTGAACACATCTTT-1	GoodQuality
GCTTGAACAGCATACT-1	GoodQuality
GCTTGAACAGGACCCT-1	GoodQuality
GCTTGAACAGTCAGCC-1	GoodQuality
GCTTGAACATGACGGA-1	LowQuality
GCTTGAAGTTGATTCG-1	GoodQuality
GCTTGAATCACGATGT-1	LowQuality
GCTTGAATCACGGTTA-1	GoodQuality
GCTTGAATCCAACCAA-1	LowQuality
GCTTGAATCCCTTGTG-1	LowQuality
GCTTGAATCGCTGATA-1	LowQuality
GCTTGAATCTAAGCCA-1	GoodQuality
GCTTGAATCTCTTGAT-1	GoodQuality
GGAAAGCAGACAGACC-1	LowQuality
GGAAAGCCAAATCCGT-1	LowQuality
GGAAAGCCAGCAGTTT-1	GoodQuality
GGAAAGCCATCACCCT-1	GoodQuality
GGAAAGCCATCCGCGA-1	GoodQuality
GGAAAGCCATTGGTAC-1	GoodQuality
GGAAAGCGTAGAAGGA-1	GoodQuality
GGAAAGCGTCAGGACA-1	GoodQuality
GGAAAGCGTCCTAGCG-1	GoodQuality
GGAAAGCGTTAAGACA-1	LowQuality
GGAAAGCTCAGAGACG-1	LowQuality
GGAAAGCTCCAAACAC-1	LowQuality
GGAAAGCTCCCATTTA-1	LowQuality
GGAAAGCTCGGCTTGG-1	LowQuality
GGAAAGCTCTCTTATG-1	LowQuality
GGAAAGCTCTGGTATG-1	GoodQuality
GGAACTTAGACGCTTT-1	GoodQuality
GGAACTTAGACTAGAT-1	LowQuality
GGAACTTAGGGCTTCC-1	GoodQuality
GGAACTTCAAACTGCT-1	GoodQuality
GGAACTTCAAGCTGTT-1	GoodQuality
GGAACTTCAATCACAC-1	LowQuality
GGAACTTCACATCTTT-1	GoodQuality
GGAACTTCAGCGTAAG-1	LowQuality
GGAACTTGTAGAGGAA-1	GoodQuality
GGAACTTGTAGCAAAT-1	GoodQuality
GGAACTTGTCGGCACT-1	LowQuality
GGAACTTGTTCGCTAA-1	LowQuality
GGAACTTTCACAGTAC-1	LowQuality
GGAACTTTCACTTCAT-1	LowQuality
GGAACTTTCGCAGGCT-1	GoodQuality
GGAATAAAGAGTAATC-1	GoodQuality
GGAATAAAGGATGTAT-1	GoodQuality
GGAATAAAGTGTTGAA-1	LowQuality
GGAATAACAGCGATCC-1	GoodQuality
GGAATAACATGCCCGA-1	GoodQuality
GGAATAAGTGTGACCC-1	LowQuality
GGAATAAGTTTGGGCC-1	LowQuality
GGAATAATCACGAAGG-1	LowQuality
GGAATAATCATTATCC-1	LowQuality
GGAATAATCCGATATG-1	GoodQuality
GGAATAATCGCTAGCG-1	GoodQuality
GGACAAGAGGATGCGT-1	GoodQuality
GGACAAGAGGCAAAGA-1	GoodQuality
GGACAAGCAAAGGAAG-1	GoodQuality
GGACAAGCAACGATCT-1	LowQuality
GGACAAGCAATCGAAA-1	GoodQuality
GGACAAGCACAACGTT-1	GoodQuality
GGACAAGCAGTGAGTG-1	GoodQuality
GGACAAGCATAGTAAG-1	GoodQuality
GGACAAGCATTAGCCA-1	LowQuality
GGACAAGGTACTTAGC-1	GoodQuality
GGACAAGGTCCGAATT-1	GoodQuality
GGACAAGGTCTCGTTC-1	LowQuality
GGACAAGTCATGCTCC-1	GoodQuality
GGACAAGTCGATAGAA-1	GoodQuality
GGACAGAAGACTACAA-1	GoodQuality
GGACAGAAGAGAGCTC-1	GoodQuality
GGACAGAAGGTAGCCA-1	LowQuality
GGACAGAAGTTCCACA-1	GoodQuality
GGACAGACACGGTGTC-1	GoodQuality
GGACAGACAGAGTGTG-1	GoodQuality
GGACAGACATCACCCT-1	GoodQuality
GGACAGAGTTAAGATG-1	GoodQuality
GGACAGAGTTTAAGCC-1	LowQuality
GGACAGATCAACACTG-1	GoodQuality
GGACAGATCACCATAG-1	GoodQuality
GGACAGATCACCCGAG-1	GoodQuality
GGACAGATCATCTGCC-1	LowQuality
GGACAGATCATGTCTT-1	GoodQuality
GGACAGATCCGCGGTA-1	GoodQuality
GGACAGATCGGTCTAA-1	GoodQuality
GGACAGATCGTTTGCC-1	GoodQuality
GGACAGATCTGACCTC-1	GoodQuality
GGACATTAGCTCAACT-1	GoodQuality
GGACATTCAAATTGCC-1	GoodQuality
GGACATTCAGCTGGCT-1	GoodQuality
GGACATTTCGAATGGG-1	GoodQuality
GGACGTCAGAACTCGG-1	GoodQuality
GGACGTCAGACGACGT-1	GoodQuality
GGACGTCAGACTGGGT-1	GoodQuality
GGACGTCAGATGGCGT-1	GoodQuality
GGACGTCAGGTGATTA-1	GoodQuality
GGACGTCAGTCACGCC-1	GoodQuality
GGACGTCCACCACGTG-1	GoodQuality
GGACGTCCAGCCTATA-1	GoodQuality
GGACGTCCATCCTAGA-1	LowQuality
GGACGTCGTCGTGGCT-1	LowQuality
GGACGTCGTGCTGTAT-1	GoodQuality
GGACGTCGTTACTGAC-1	LowQuality
GGACGTCGTTCCACTC-1	GoodQuality
GGACGTCTCAAACCAC-1	LowQuality
GGACGTCTCAGGATCT-1	LowQuality
GGACGTCTCCTAGAAC-1	GoodQuality
GGACGTCTCGTGACAT-1	GoodQuality
GGAGCAAAGTGAACGC-1	GoodQuality
GGAGCAAAGTGAAGAG-1	GoodQuality
GGAGCAAAGTGCGATG-1	GoodQuality
GGAGCAAAGTGTCCCG-1	LowQuality
GGAGCAACAAATACAG-1	GoodQuality
GGAGCAACAAGAAGAG-1	GoodQuality
GGAGCAACACATGACT-1	LowQuality
GGAGCAACACGTCTCT-1	LowQuality
GGAGCAACAGACACTT-1	LowQuality
GGAGCAACAGACAGGT-1	GoodQuality
GGAGCAACATCCGTGG-1	GoodQuality
GGAGCAACATGCCTAA-1	LowQuality
GGAGCAAGTAACGTTC-1	LowQuality
GGAGCAAGTAGAAGGA-1	LowQuality
GGAGCAAGTCATATGC-1	LowQuality
GGAGCAAGTGAGGCTA-1	GoodQuality
GGAGCAAGTGATGTCT-1	GoodQuality
GGAGCAAGTTCCACTC-1	GoodQuality
GGAGCAAGTTCCGGCA-1	GoodQuality
GGAGCAATCGGATGGA-1	GoodQuality
GGATGTTAGAATTGTG-1	GoodQuality
GGATGTTAGACAGAGA-1	GoodQuality
GGATGTTAGACTTGAA-1	GoodQuality
GGATGTTAGGCTCAGA-1	GoodQuality
GGATGTTAGTACGTTC-1	LowQuality
GGATGTTAGTTCGCAT-1	GoodQuality
GGATGTTCAAGAAAGG-1	GoodQuality
GGATGTTCAAGTCTAC-1	GoodQuality
GGATGTTCATATACCG-1	GoodQuality
GGATGTTCATATACGC-1	LowQuality
GGATGTTGTCCAGTGC-1	LowQuality
GGATGTTGTGGTAACG-1	LowQuality
GGATGTTGTGTGACCC-1	GoodQuality
GGATGTTGTTACGCGC-1	LowQuality
GGATGTTTCAACACTG-1	GoodQuality
GGATGTTTCACATGCA-1	GoodQuality
GGATGTTTCACGATGT-1	GoodQuality
GGATGTTTCCTTGACC-1	LowQuality
GGATTACAGTCCGGTC-1	LowQuality
GGATTACCACAGACAG-1	GoodQuality
GGATTACCACCCATGG-1	GoodQuality
GGATTACCAGGTGGAT-1	GoodQuality
GGATTACCAGTATAAG-1	GoodQuality
GGATTACTCAGCTGGC-1	LowQuality
GGATTACTCCCGGATG-1	GoodQuality
GGATTACTCGAATGCT-1	LowQuality
GGATTACTCTGGCGAC-1	GoodQuality
GGCAATTAGAAGGTGA-1	GoodQuality
GGCAATTCAAAGCGGT-1	GoodQuality
GGCAATTCAACACCCG-1	LowQuality
GGCAATTCAAGTCTAC-1	LowQuality
GGCAATTCAGCCTGTG-1	LowQuality
GGCAATTCAGGAACGT-1	GoodQuality
GGCAATTCATATACGC-1	GoodQuality
GGCAATTCATCCGCGA-1	GoodQuality
GGCAATTCATTAACCG-1	GoodQuality
GGCAATTGTCCTGCTT-1	GoodQuality
GGCAATTGTCTCATCC-1	LowQuality
GGCAATTGTCTTGATG-1	GoodQuality
GGCAATTGTCTTTCAT-1	LowQuality
GGCAATTGTTATGCGT-1	LowQuality
GGCAATTTCTACTCAT-1	GoodQuality
GGCAATTTCTCAAACG-1	GoodQuality
GGCAATTTCTTCTGGC-1	GoodQuality
GGCCGATCAGTCGATT-1	GoodQuality
GGCCGATGTACGCTGC-1	GoodQuality
GGCCGATGTCAATGTC-1	LowQuality
GGCCGATGTCCAACTA-1	GoodQuality
GGCCGATGTGCACTTA-1	GoodQuality
GGCCGATGTGTGACGA-1	GoodQuality
GGCCGATGTTAGTGGG-1	GoodQuality
GGCCGATTCGGCTACG-1	GoodQuality
GGCCGATTCTGCCCTA-1	GoodQuality
GGCGACTAGAAGGTTT-1	GoodQuality
GGCGACTAGCCGATTT-1	LowQuality
GGCGACTCAAACTGTC-1	GoodQuality
GGCGACTCAATGCCAT-1	LowQuality
GGCGACTCACATCTTT-1	LowQuality
GGCGACTCAGACTCGC-1	GoodQuality
GGCGACTCAGCCAATT-1	LowQuality
GGCGACTGTATAAACG-1	LowQuality
GGCGACTTCTCGCATC-1	GoodQuality
GGCGACTTCTGGAGCC-1	LowQuality
GGCGTGTAGACAGAGA-1	GoodQuality
GGCGTGTAGCGCCTTG-1	LowQuality
GGCGTGTAGTGTTAGA-1	GoodQuality
GGCGTGTCAAGGACTG-1	GoodQuality
GGCGTGTCACCAGCAC-1	LowQuality
GGCGTGTCACTTCTGC-1	LowQuality
GGCGTGTGTTGAGTTC-1	GoodQuality
GGCGTGTTCGTCTGAA-1	GoodQuality
GGCTCGAAGGGCTTGA-1	GoodQuality
GGCTCGAAGTGAAGAG-1	GoodQuality
GGCTCGACAATCACAC-1	GoodQuality
GGCTCGACACCAGGCT-1	LowQuality
GGCTCGAGTGCCTGCA-1	GoodQuality
GGCTCGAGTTAGATGA-1	LowQuality
GGCTCGATCACCAGGC-1	GoodQuality
GGCTCGATCCAACCAA-1	GoodQuality
GGCTCGATCCACGCAG-1	GoodQuality
GGCTCGATCTGATACG-1	LowQuality
GGCTCGATCTGGGCCA-1	GoodQuality
GGCTGGTAGGATGCGT-1	GoodQuality
GGCTGGTCAAGGGTCA-1	LowQuality
GGCTGGTCACCGATAT-1	LowQuality
GGCTGGTCATGGGAAC-1	GoodQuality
GGCTGGTGTGATGCCC-1	LowQuality
GGCTGGTGTGCCTGGT-1	GoodQuality
GGCTGGTGTGCTGTAT-1	GoodQuality
GGCTGGTGTTAAAGAC-1	GoodQuality
GGCTGGTTCACCATAG-1	LowQuality
GGCTGGTTCGCGTTTC-1	LowQuality
GGCTGGTTCTCCAACC-1	GoodQuality
GGCTGGTTCTGAGGGA-1	GoodQuality
GGGAATGAGCGACGTA-1	LowQuality
GGGAATGAGCGTTGCC-1	LowQuality
GGGAATGAGCTAACAA-1	GoodQuality
GGGAATGAGGACACCA-1	GoodQuality
GGGAATGAGGGAACGG-1	LowQuality
GGGAATGAGGTAGCCA-1	GoodQuality
GGGAATGAGGTGGGTT-1	LowQuality
GGGAATGCACATTCGA-1	GoodQuality
GGGAATGCACGTAAGG-1	LowQuality
GGGAATGGTGTTTGGT-1	GoodQuality
GGGAATGGTTATGCGT-1	GoodQuality
GGGAATGTCTAACTCT-1	GoodQuality
GGGACCTAGACAATAC-1	GoodQuality
GGGACCTAGCCAGTTT-1	LowQuality
GGGACCTAGTTATCGC-1	LowQuality
GGGACCTAGTTTCCTT-1	GoodQuality
GGGACCTCAACACCCG-1	GoodQuality
GGGACCTCAAGCTGGA-1	LowQuality
GGGACCTCAAGTACCT-1	LowQuality
GGGACCTCAGATGGCA-1	GoodQuality
GGGACCTCATACGCTA-1	LowQuality
GGGACCTCATCGTCGG-1	GoodQuality
GGGACCTCATGAGCGA-1	GoodQuality
GGGACCTGTAATCGTC-1	GoodQuality
GGGACCTGTAGCGATG-1	LowQuality
GGGACCTGTCACTTCC-1	GoodQuality
GGGACCTGTGTTTGTG-1	GoodQuality
GGGACCTTCCCTCTTT-1	GoodQuality
GGGAGATAGCTAAACA-1	GoodQuality
GGGAGATAGTGGTAGC-1	LowQuality
GGGAGATCAATAAGCA-1	GoodQuality
GGGAGATCAGCCTATA-1	GoodQuality
GGGAGATGTACTTCTT-1	GoodQuality
GGGAGATGTCCCGACA-1	GoodQuality
GGGAGATGTGCTCTTC-1	GoodQuality
GGGAGATGTGTGCGTC-1	GoodQuality
GGGAGATTCCATGCTC-1	LowQuality
GGGAGATTCCCGGATG-1	GoodQuality
GGGATGAAGGTAGCCA-1	GoodQuality
GGGATGAAGTAGATGT-1	LowQuality
GGGATGAAGTCCTCCT-1	LowQuality
GGGATGAAGTTAACGA-1	GoodQuality
GGGATGACACCAGGCT-1	GoodQuality
GGGATGATCATCGCTC-1	LowQuality
GGGATGATCCTTTACA-1	GoodQuality
GGGCACTAGAGTAAGG-1	GoodQuality
GGGCACTAGTCAAGGC-1	GoodQuality
GGGCACTCATCGGGTC-1	LowQuality
GGGCACTCATGCGCAC-1	GoodQuality
GGGCACTGTAAGGGAA-1	LowQuality
GGGCACTTCACCATAG-1	GoodQuality
GGGCACTTCCAAGCCG-1	GoodQuality
GGGCACTTCCCGGATG-1	GoodQuality
GGGCACTTCCTATGTT-1	LowQuality
GGGCACTTCGGCCGAT-1	LowQuality
GGGCATCAGAAACCAT-1	GoodQuality
GGGCATCAGACACGAC-1	GoodQuality
GGGCATCAGTGGGCTA-1	GoodQuality
GGGCATCCACCCTATC-1	GoodQuality
GGGCATCGTAGCACGA-1	LowQuality
GGGCATCGTCGCTTTC-1	GoodQuality
GGGCATCTCAGGCGAA-1	LowQuality
GGGCATCTCAGTTCGA-1	GoodQuality
GGGCATCTCATGTAGC-1	GoodQuality
GGGCATCTCGCACTCT-1	GoodQuality
GGGCATCTCGCTTGTC-1	GoodQuality
GGGTCTGAGACTGGGT-1	GoodQuality
GGGTCTGAGCAATATG-1	GoodQuality
GGGTCTGAGGCTAGGT-1	GoodQuality
GGGTCTGAGGCTCTTA-1	GoodQuality
GGGTCTGCAGTGGGAT-1	GoodQuality
GGGTCTGGTGTGACCC-1	LowQuality
GGGTCTGGTTCACGGC-1	GoodQuality
GGGTCTGTCCCTCAGT-1	GoodQuality
GGGTCTGTCCTGTACC-1	GoodQuality
GGGTCTGTCGTGACAT-1	LowQuality
GGGTCTGTCTTGCATT-1	GoodQuality
GGGTTGCAGAATGTTG-1	GoodQuality
GGGTTGCAGATCGATA-1	GoodQuality
GGGTTGCAGCACCGTC-1	LowQuality
GGGTTGCAGTGAAGAG-1	GoodQuality
GGGTTGCAGTTACCCA-1	LowQuality
GGGTTGCCAAGTCTAC-1	LowQuality
GGGTTGCCACAGGCCT-1	GoodQuality
GGGTTGCCAGACGCCT-1	LowQuality
GGGTTGCCAGCTCCGA-1	LowQuality
GGGTTGCCAGTCCTTC-1	LowQuality
GGGTTGCGTAGGCTGA-1	GoodQuality
GGGTTGCGTATCGCAT-1	LowQuality
GGGTTGCGTATGGTTC-1	GoodQuality
GGGTTGCGTTGTCGCG-1	LowQuality
GGGTTGCGTTGTCTTT-1	GoodQuality
GGGTTGCTCGCATGAT-1	GoodQuality
GGGTTGCTCTTGTATC-1	GoodQuality
GGTATTGAGACATAAC-1	GoodQuality
GGTATTGAGGCCCGTT-1	GoodQuality
GGTATTGAGGGTCTCC-1	GoodQuality
GGTATTGAGTAAGTAC-1	LowQuality
GGTATTGCAAGTAATG-1	GoodQuality
GGTATTGCAATGAATG-1	GoodQuality
GGTATTGCATCGGAAG-1	GoodQuality
GGTATTGCATCGTCGG-1	GoodQuality
GGTATTGGTCACCTAA-1	GoodQuality
GGTATTGGTGCTAGCC-1	GoodQuality
GGTATTGGTTAGATGA-1	LowQuality
GGTATTGGTTCCATGA-1	GoodQuality
GGTATTGGTTGGTTTG-1	LowQuality
GGTATTGGTTTGGCGC-1	LowQuality
GGTATTGTCAACACCA-1	GoodQuality
GGTATTGTCATAGCAC-1	GoodQuality
GGTATTGTCATTATCC-1	LowQuality
GGTGAAGAGACAGGCT-1	GoodQuality
GGTGAAGAGCGAGAAA-1	GoodQuality
GGTGAAGAGCTGATAA-1	GoodQuality
GGTGAAGAGTGGGCTA-1	GoodQuality
GGTGAAGAGTGGTAAT-1	GoodQuality
GGTGAAGCAATCGAAA-1	GoodQuality
GGTGAAGCAATGAATG-1	GoodQuality
GGTGAAGCAGCCAGAA-1	GoodQuality
GGTGAAGCAGTCGTGC-1	LowQuality
GGTGAAGCATAAGACA-1	GoodQuality
GGTGAAGCATACGCCG-1	GoodQuality
GGTGAAGGTCAATACC-1	GoodQuality
GGTGAAGGTTCACCTC-1	GoodQuality
GGTGAAGGTTGGAGGT-1	LowQuality
GGTGAAGTCAGGTTCA-1	GoodQuality
GGTGAAGTCAGTTCGA-1	GoodQuality
GGTGAAGTCCGGGTGT-1	GoodQuality
GGTGAAGTCGTTTATC-1	LowQuality
GGTGCGTAGACTAAGT-1	GoodQuality
GGTGCGTAGCCAGTAG-1	GoodQuality
GGTGCGTAGGTGATAT-1	GoodQuality
GGTGCGTAGTTATCGC-1	GoodQuality
GGTGCGTCACACCGAC-1	LowQuality
GGTGCGTCACCGGAAA-1	GoodQuality
GGTGCGTCAGCGTAAG-1	GoodQuality
GGTGCGTCAGTCGATT-1	LowQuality
GGTGCGTCATGTAAGA-1	GoodQuality
GGTGCGTCATGTTGAC-1	GoodQuality
GGTGCGTGTCGAAAGC-1	GoodQuality
GGTGCGTTCACAAACC-1	GoodQuality
GGTGCGTTCAGCGATT-1	LowQuality
GGTGCGTTCCGTCATC-1	GoodQuality
GGTGCGTTCCTAGAAC-1	GoodQuality
GGTGCGTTCTGCAAGT-1	GoodQuality
GGTGTTAAGCCGCCTA-1	GoodQuality
GGTGTTAAGCTGCCCA-1	GoodQuality
GGTGTTAAGGAGCGTT-1	GoodQuality
GGTGTTAAGTGGGTTG-1	LowQuality
GGTGTTACACTTAACG-1	GoodQuality
GGTGTTAGTCTAGAGG-1	GoodQuality
GGTGTTATCAAACCAC-1	GoodQuality
GGTGTTATCACTATTC-1	GoodQuality
GGTGTTATCATAGCAC-1	GoodQuality
GGTGTTATCTCCTATA-1	GoodQuality
GGTGTTATCTGAGGGA-1	LowQuality
GGTGTTATCTGGTTCC-1	GoodQuality
GTAACGTAGACGCTTT-1	LowQuality
GTAACGTAGATCGATA-1	GoodQuality
GTAACGTAGATCTGAA-1	GoodQuality
GTAACGTAGTGTACTC-1	GoodQuality
GTAACGTCACATGTGT-1	GoodQuality
GTAACGTCACCAGGCT-1	LowQuality
GTAACGTCATCACGAT-1	GoodQuality
GTAACGTCATCAGTAC-1	GoodQuality
GTAACGTGTAGTACCT-1	GoodQuality
GTAACGTGTCTCTCGT-1	LowQuality
GTAACGTGTGTTCTTT-1	GoodQuality
GTAACGTTCCGAACGC-1	GoodQuality
GTAACGTTCCTTCAAT-1	LowQuality
GTAACGTTCGCATGGC-1	GoodQuality
GTAACGTTCTCGTTTA-1	GoodQuality
GTAACTGAGAGTACCG-1	GoodQuality
GTAACTGAGCCAGTAG-1	GoodQuality
GTAACTGAGCCCGAAA-1	LowQuality
GTAACTGAGCCTCGTG-1	GoodQuality
GTAACTGAGGTGTGGT-1	GoodQuality
GTAACTGAGTCCTCCT-1	LowQuality
GTAACTGCAATGAATG-1	GoodQuality
GTAACTGCAGTGAGTG-1	LowQuality
GTAACTGGTAGCGTCC-1	GoodQuality
GTAACTGGTGCGCTTG-1	LowQuality
GTAACTGGTTAAGTAG-1	GoodQuality
GTAACTGTCTAAGCCA-1	GoodQuality
GTACGTACACAGATTC-1	GoodQuality
GTACGTACAGATGGGT-1	GoodQuality
GTACGTACAGGGCATA-1	LowQuality
GTACGTACATAGTAAG-1	LowQuality
GTACGTAGTATAATGG-1	LowQuality
GTACGTAGTCATCCCT-1	GoodQuality
GTACGTAGTGCTTCTC-1	GoodQuality
GTACGTAGTTGATTCG-1	GoodQuality
GTACGTATCAACACGT-1	GoodQuality
GTACGTATCAATACCG-1	GoodQuality
GTACGTATCTGGGCCA-1	GoodQuality
GTACTCCAGCGAGAAA-1	LowQuality
GTACTCCAGCTGAAAT-1	GoodQuality
GTACTCCAGGAATTAC-1	GoodQuality
GTACTCCAGTATGACA-1	LowQuality
GTACTCCCAGTATGCT-1	GoodQuality
GTACTCCCATCTGGTA-1	GoodQuality
GTACTCCGTAAGTGGC-1	GoodQuality
GTACTCCGTCATGCCG-1	LowQuality
GTACTCCGTGCACCAC-1	GoodQuality
GTACTCCGTTCACCTC-1	LowQuality
GTACTCCGTTGGTAAA-1	GoodQuality
GTACTCCTCCTATGTT-1	GoodQuality
GTACTCCTCGGTTCGG-1	GoodQuality
GTACTCCTCTGCAGTA-1	LowQuality
GTACTTTAGCAATATG-1	LowQuality
GTACTTTAGCAGGCTA-1	GoodQuality
GTACTTTAGGACTGGT-1	GoodQuality
GTACTTTAGGGTATCG-1	LowQuality
GTACTTTCATCGTCGG-1	GoodQuality
GTACTTTCATCTCCCA-1	LowQuality
GTACTTTGTGATAAAC-1	LowQuality
GTACTTTGTGCTGTAT-1	LowQuality
GTACTTTTCCAAGCCG-1	GoodQuality
GTACTTTTCGATAGAA-1	LowQuality
GTACTTTTCTACTATC-1	GoodQuality
GTAGGCCAGAGCTTCT-1	GoodQuality
GTAGGCCAGCGCCTTG-1	GoodQuality
GTAGGCCAGCTACCGC-1	LowQuality
GTAGGCCCAAGACGTG-1	GoodQuality
GTAGGCCCAAGCGATG-1	LowQuality
GTAGGCCCAAGCGTAG-1	GoodQuality
GTAGGCCCAGATCGGA-1	GoodQuality
GTAGGCCCAGGAACGT-1	GoodQuality
GTAGGCCCAGTGGAGT-1	LowQuality
GTAGGCCGTACGAAAT-1	GoodQuality
GTAGGCCGTCTCAACA-1	GoodQuality
GTAGGCCGTCTGGAGA-1	LowQuality
GTAGGCCGTGCCTGTG-1	GoodQuality
GTAGGCCGTGGTCTCG-1	LowQuality
GTAGGCCTCCACGTTC-1	LowQuality
GTAGGCCTCCAGGGCT-1	GoodQuality
GTAGGCCTCCGCGTTT-1	GoodQuality
GTAGGCCTCTTTACGT-1	GoodQuality
GTAGTCACACGTTGGC-1	LowQuality
GTAGTCAGTAGATTAG-1	LowQuality
GTAGTCAGTCACACGC-1	LowQuality
GTAGTCAGTCTCAACA-1	GoodQuality
GTAGTCAGTGACGGTA-1	GoodQuality
GTATCTTAGATTACCC-1	LowQuality
GTATCTTAGGCATGTG-1	GoodQuality
GTATCTTAGGTGCTAG-1	GoodQuality
GTATCTTAGTAGCCGA-1	GoodQuality
GTATCTTCAAGAAGAG-1	LowQuality
GTATCTTCACGCGAAA-1	GoodQuality
GTATCTTCAGACAAAT-1	GoodQuality
GTATCTTCATCCGCGA-1	GoodQuality
GTATCTTGTTTGCATG-1	LowQuality
GTATCTTTCATAAAGG-1	GoodQuality
GTATCTTTCATCGCTC-1	GoodQuality
GTATCTTTCTTATCTG-1	GoodQuality
GTATCTTTCTTTACGT-1	GoodQuality
GTATTCTAGAGGACGG-1	LowQuality
GTATTCTAGATGTGGC-1	LowQuality
GTATTCTAGTACGATA-1	LowQuality
GTATTCTAGTTCGATC-1	GoodQuality
GTATTCTCAGACTCGC-1	LowQuality
GTATTCTCAGAGTGTG-1	GoodQuality
GTATTCTCATGGATGG-1	GoodQuality
GTATTCTCATTCTTAC-1	GoodQuality
GTATTCTGTAAATGAC-1	GoodQuality
GTATTCTGTCCGACGT-1	GoodQuality
GTATTCTGTTCACCTC-1	LowQuality
GTATTCTGTTCCGGCA-1	LowQuality
GTATTCTTCTGGCGAC-1	LowQuality
GTATTCTTCTGTCCGT-1	LowQuality
GTATTCTTCTTGACGA-1	GoodQuality
GTATTCTTCTTGTATC-1	LowQuality
GTCAAGTAGGAATTAC-1	GoodQuality
GTCAAGTAGGCTAGCA-1	GoodQuality
GTCAAGTAGTATGACA-1	GoodQuality
GTCAAGTAGTGGAGAA-1	LowQuality
GTCAAGTCAAACTGCT-1	GoodQuality
GTCAAGTCAACAACCT-1	GoodQuality
GTCAAGTCAACGATCT-1	GoodQuality
GTCAAGTCACCTCGTT-1	GoodQuality
GTCAAGTCAGGTCTCG-1	GoodQuality
GTCAAGTCATGAACCT-1	GoodQuality
GTCAAGTGTAAACACA-1	GoodQuality
GTCAAGTGTAAGTGGC-1	GoodQuality
GTCAAGTGTAGCTTGT-1	LowQuality
GTCAAGTTCGGCTTGG-1	LowQuality
GTCAAGTTCTGTCTAT-1	LowQuality
GTCACAAAGATGTTAG-1	GoodQuality
GTCACAAAGCGTTCCG-1	GoodQuality
GTCACAAAGCTAACTC-1	LowQuality
GTCACAAAGGGCACTA-1	GoodQuality
GTCACAACAAACAACA-1	GoodQuality
GTCACAACACATAACC-1	GoodQuality
GTCACAACACGAAAGC-1	GoodQuality
GTCACAAGTTACCAGT-1	LowQuality
GTCACAAGTTGGGACA-1	GoodQuality
GTCACAATCAAACAAG-1	GoodQuality
GTCACAATCCCTAATT-1	GoodQuality
GTCACAATCGCCAGCA-1	GoodQuality
GTCACGGAGACCGGAT-1	GoodQuality
GTCACGGAGTCAAGGC-1	GoodQuality
GTCACGGAGTGGGATC-1	LowQuality
GTCACGGGTACTTAGC-1	GoodQuality
GTCACGGGTCCGACGT-1	GoodQuality
GTCACGGGTGAGGGAG-1	GoodQuality
GTCACGGGTTCGAATC-1	GoodQuality
GTCACGGGTTTGTTTC-1	GoodQuality
GTCACGGTCAATAAGG-1	GoodQuality
GTCACGGTCACCCGAG-1	GoodQuality
GTCACGGTCACCGTAA-1	GoodQuality
GTCACGGTCCAGAGGA-1	LowQuality
GTCATTTAGATCCCGC-1	LowQuality
GTCATTTAGCAGCCTC-1	LowQuality
GTCATTTAGCAGCGTA-1	LowQuality
GTCATTTAGCGTAATA-1	GoodQuality
GTCATTTAGTTCCACA-1	GoodQuality
GTCATTTCAAGAAAGG-1	GoodQuality
GTCATTTCACAGGTTT-1	GoodQuality
GTCATTTCACGAGAGT-1	GoodQuality
GTCATTTGTCCGACGT-1	GoodQuality
GTCATTTGTCTAGTGT-1	GoodQuality
GTCATTTGTCTGGAGA-1	GoodQuality
GTCATTTGTGCGGTAA-1	GoodQuality
GTCCTCAAGATGGGTC-1	GoodQuality
GTCCTCAAGCTGTTCA-1	GoodQuality
GTCCTCAAGGCATGGT-1	LowQuality
GTCCTCACATATGCTG-1	GoodQuality
GTCCTCACATCCTTGC-1	GoodQuality
GTCCTCAGTAACGCGA-1	GoodQuality
GTCCTCAGTCGAATCT-1	GoodQuality
GTCCTCAGTTCGAATC-1	GoodQuality
GTCCTCAGTTGTCTTT-1	LowQuality
GTCCTCATCCTAGGGC-1	GoodQuality
GTCCTCATCCTATTCA-1	GoodQuality
GTCCTCATCGAACTGT-1	GoodQuality
GTCCTCATCTTGTACT-1	GoodQuality
GTCGGGTAGGCTACGA-1	GoodQuality
GTCGGGTAGGTGCACA-1	GoodQuality
GTCGGGTAGTGTACTC-1	GoodQuality
GTCGGGTCAAAGCGGT-1	GoodQuality
GTCGGGTCACAGGCCT-1	GoodQuality
GTCGGGTCAGGATTGG-1	GoodQuality
GTCGGGTCAGTAACGG-1	GoodQuality
GTCGGGTTCAGGATCT-1	LowQuality
GTCGGGTTCCAGAAGG-1	GoodQuality
GTCGGGTTCCCAACGG-1	LowQuality
GTCGGGTTCGCGTTTC-1	GoodQuality
GTCGTAAAGACACTAA-1	GoodQuality
GTCGTAAAGAGTGACC-1	GoodQuality
GTCGTAAAGTGGACGT-1	LowQuality
GTCGTAACACCTGGTG-1	LowQuality
GTCGTAACATCACGAT-1	LowQuality
GTCGTAACATGTTGAC-1	LowQuality
GTCGTAAGTAGCGTCC-1	GoodQuality
GTCGTAAGTCCCTACT-1	LowQuality
GTCGTAAGTCCGCTGA-1	GoodQuality
GTCGTAATCACTTACT-1	LowQuality
GTCGTAATCATCGCTC-1	GoodQuality
GTCGTAATCATGCATG-1	GoodQuality
GTCGTAATCATGGTCA-1	GoodQuality
GTCGTAATCGCTTGTC-1	GoodQuality
GTCGTAATCGTCCAGG-1	GoodQuality
GTCGTAATCTTTACGT-1	GoodQuality
GTCTCGTAGCACACAG-1	GoodQuality
GTCTCGTAGGAGTAGA-1	GoodQuality
GTCTCGTAGGTTCCTA-1	LowQuality
GTCTCGTAGTACGCCC-1	GoodQuality
GTCTCGTCAAGCGCTC-1	LowQuality
GTCTCGTCATATACCG-1	GoodQuality
GTCTCGTGTCAGCTAT-1	GoodQuality
GTCTCGTGTCCCTTGT-1	GoodQuality
GTCTCGTGTGTTAAGA-1	GoodQuality
GTCTCGTTCATGTAGC-1	GoodQuality
GTCTCGTTCCGCGTTT-1	GoodQuality
GTCTCGTTCGTAGGAG-1	LowQuality
GTCTTCGAGCAGATCG-1	GoodQuality
GTCTTCGAGCGAGAAA-1	LowQuality
GTCTTCGAGGCTCATT-1	GoodQuality
GTCTTCGAGTTCGCGC-1	GoodQuality
GTCTTCGCACGGTAGA-1	GoodQuality
GTCTTCGCAGGCTCAC-1	LowQuality
GTCTTCGGTACCCAAT-1	GoodQuality
GTCTTCGTCTGCGGCA-1	LowQuality
GTGAAGGAGAGATGAG-1	GoodQuality
GTGAAGGAGATACACA-1	GoodQuality
GTGAAGGAGGATATAC-1	GoodQuality
GTGAAGGAGGTGCTAG-1	LowQuality
GTGAAGGAGTGACATA-1	GoodQuality
GTGAAGGAGTTGTAGA-1	GoodQuality
GTGAAGGGTGTAATGA-1	LowQuality
GTGAAGGGTGTGCCTG-1	GoodQuality
GTGAAGGGTTGGTAAA-1	LowQuality
GTGAAGGTCAACACTG-1	GoodQuality
GTGAAGGTCCAGATCA-1	GoodQuality
GTGCAGCAGAGACGAA-1	GoodQuality
GTGCAGCCATCGGTTA-1	LowQuality
GTGCAGCGTCACAAGG-1	GoodQuality
GTGCAGCTCATGTCCC-1	GoodQuality
GTGCAGCTCCACGTTC-1	GoodQuality
GTGCAGCTCGCCAGCA-1	GoodQuality
GTGCATAAGCTATGCT-1	LowQuality
GTGCATACACGAAGCA-1	GoodQuality
GTGCATACAGTCACTA-1	GoodQuality
GTGCATACATCACAAC-1	GoodQuality
GTGCATACATGCCCGA-1	GoodQuality
GTGCATAGTAGCGTGA-1	GoodQuality
GTGCATAGTCGGGTCT-1	LowQuality
GTGCATAGTTGAACTC-1	LowQuality
GTGCATATCTAACGGT-1	GoodQuality
GTGCGGTAGAAACGAG-1	GoodQuality
GTGCGGTAGCCACGCT-1	LowQuality
GTGCGGTAGCTGTTCA-1	LowQuality
GTGCGGTCAGGCTCAC-1	GoodQuality
GTGCGGTCAGGTCGTC-1	GoodQuality
GTGCGGTGTACATGTC-1	GoodQuality
GTGCGGTTCACCACCT-1	GoodQuality
GTGCGGTTCCGAACGC-1	LowQuality
GTGCGGTTCGCGCCAA-1	LowQuality
GTGCGGTTCGGAGGTA-1	GoodQuality
GTGCGGTTCTAGCACA-1	GoodQuality
GTGCTTCAGATCCGAG-1	GoodQuality
GTGCTTCAGGCACATG-1	GoodQuality
GTGCTTCAGGTAAACT-1	LowQuality
GTGCTTCAGTGACTCT-1	GoodQuality
GTGCTTCCAATGGAAT-1	GoodQuality
GTGCTTCCACACATGT-1	LowQuality
GTGCTTCCAGAGTGTG-1	LowQuality
GTGCTTCCATCGGACC-1	LowQuality
GTGCTTCGTCCATCCT-1	GoodQuality
GTGCTTCGTGCGATAG-1	GoodQuality
GTGCTTCGTGTTTGTG-1	GoodQuality
GTGCTTCTCAAACCAC-1	GoodQuality
GTGCTTCTCAACACAC-1	GoodQuality
GTGCTTCTCGTCTGAA-1	GoodQuality
GTGCTTCTCTCGAGTA-1	GoodQuality
GTGCTTCTCTGCTGTC-1	GoodQuality
GTGGGTCAGTAACCCT-1	GoodQuality
GTGGGTCAGTCGCCGT-1	GoodQuality
GTGGGTCCAACTGGCC-1	LowQuality
GTGGGTCCAACTTGAC-1	GoodQuality
GTGGGTCCACCCTATC-1	GoodQuality
GTGGGTCCAGGGCATA-1	GoodQuality
GTGGGTCCATACTCTT-1	GoodQuality
GTGGGTCCATGCATGT-1	GoodQuality
GTGGGTCCATGTCTCC-1	GoodQuality
GTGGGTCGTAACGTTC-1	GoodQuality
GTGGGTCGTCTCCATC-1	GoodQuality
GTGGGTCTCGAATGGG-1	LowQuality
GTGTGCGAGACCCACC-1	GoodQuality
GTGTGCGAGATATACG-1	GoodQuality
GTGTGCGAGCGTGAGT-1	GoodQuality
GTGTGCGAGTGGCACA-1	GoodQuality
GTGTGCGAGTTACGGG-1	GoodQuality
GTGTGCGCAAATCCGT-1	LowQuality
GTGTGCGCATATACGC-1	GoodQuality
GTGTGCGGTACAGTTC-1	GoodQuality
GTGTGCGGTTCCCTTG-1	LowQuality
GTGTGCGTCAAAGACA-1	LowQuality
GTGTGCGTCCTACAGA-1	LowQuality
GTGTGCGTCCTAGTGA-1	LowQuality
GTGTGCGTCTGGGCCA-1	GoodQuality
GTGTTAGAGATTACCC-1	GoodQuality
GTGTTAGAGTGACATA-1	GoodQuality
GTGTTAGAGTGCGATG-1	LowQuality
GTGTTAGCAATACGCT-1	LowQuality
GTGTTAGCAATCCGAT-1	GoodQuality
GTGTTAGCACCATCCT-1	LowQuality
GTGTTAGCACGACTCG-1	LowQuality
GTGTTAGGTACAAGTA-1	GoodQuality
GTGTTAGGTCTAACGT-1	LowQuality
GTGTTAGGTTACGACT-1	GoodQuality
GTGTTAGTCCCAAGAT-1	GoodQuality
GTTAAGCAGACTTTCG-1	GoodQuality
GTTAAGCAGCCGCCTA-1	LowQuality
GTTAAGCAGGCTATCT-1	LowQuality
GTTAAGCAGTGGGCTA-1	GoodQuality
GTTAAGCCAAAGCAAT-1	GoodQuality
GTTAAGCCACAGACAG-1	GoodQuality
GTTAAGCCACAGCCCA-1	GoodQuality
GTTAAGCCACGTTGGC-1	GoodQuality
GTTAAGCCACTAAGTC-1	GoodQuality
GTTAAGCCAGGTGGAT-1	GoodQuality
GTTAAGCGTGGTCCGT-1	LowQuality
GTTAAGCGTTCCCGAG-1	GoodQuality
GTTAAGCGTTGTTTGG-1	GoodQuality
GTTAAGCTCAGCATGT-1	LowQuality
GTTAAGCTCCGCGTTT-1	GoodQuality
GTTACAGAGTCCCACG-1	LowQuality
GTTACAGCAAGAAAGG-1	LowQuality
GTTACAGCACCCATGG-1	GoodQuality
GTTACAGGTGACGGTA-1	GoodQuality
GTTACAGTCAACACGT-1	LowQuality
GTTACAGTCACATAGC-1	LowQuality
GTTACAGTCAGGCGAA-1	LowQuality
GTTACAGTCCTGCTTG-1	LowQuality
GTTACAGTCTACCTGC-1	GoodQuality
GTTACAGTCTATCGCC-1	LowQuality
GTTACAGTCTGGTTCC-1	LowQuality
GTTACAGTCTGTACGA-1	LowQuality
GTTCATTAGAAGGTTT-1	GoodQuality
GTTCATTAGAATCTCC-1	GoodQuality
GTTCATTAGCAGATCG-1	GoodQuality
GTTCATTAGCATGGCA-1	GoodQuality
GTTCATTAGCTGTCTA-1	GoodQuality
GTTCATTAGGTGTTAA-1	GoodQuality
GTTCATTAGTGGACGT-1	LowQuality
GTTCATTCAATAACGA-1	GoodQuality
GTTCATTCACATCCAA-1	LowQuality
GTTCATTCATTCCTGC-1	GoodQuality
GTTCATTGTCACCCAG-1	LowQuality
GTTCATTGTGCACGAA-1	GoodQuality
GTTCATTGTTACAGAA-1	LowQuality
GTTCATTGTTCCACAA-1	LowQuality
GTTCGGGAGCGTGAAC-1	LowQuality
GTTCGGGAGGATGTAT-1	GoodQuality
GTTCGGGAGTGTCCAT-1	GoodQuality
GTTCGGGCACGGTTTA-1	GoodQuality
GTTCGGGCAGTTTACG-1	GoodQuality
GTTCGGGCATGCAATC-1	GoodQuality
GTTCGGGGTCATATGC-1	GoodQuality
GTTCGGGTCACCGTAA-1	GoodQuality
GTTCGGGTCCAGGGCT-1	GoodQuality
GTTCGGGTCCTCAACC-1	GoodQuality
GTTCGGGTCTCCCTGA-1	GoodQuality
GTTCTCGAGAAGCCCA-1	GoodQuality
GTTCTCGAGCTAGCCC-1	GoodQuality
GTTCTCGAGGCGTACA-1	GoodQuality
GTTCTCGAGTACACCT-1	LowQuality
GTTCTCGAGTCGAGTG-1	LowQuality
GTTCTCGCAAACCTAC-1	GoodQuality
GTTCTCGCACAACTGT-1	GoodQuality
GTTCTCGCATCACCCT-1	LowQuality
GTTCTCGGTCAGTGGA-1	GoodQuality
GTTCTCGGTCCGAACC-1	LowQuality
GTTCTCGGTCGAACAG-1	GoodQuality
GTTCTCGGTCGGCATC-1	GoodQuality
GTTCTCGGTTGCTCCT-1	LowQuality
GTTCTCGTCGAATGGG-1	GoodQuality
GTTCTCGTCTGCAAGT-1	GoodQuality
GTTTCTAAGAACTGTA-1	GoodQuality
GTTTCTAAGCGATCCC-1	GoodQuality
GTTTCTAAGCTGAACG-1	GoodQuality
GTTTCTAAGTAGGTGC-1	GoodQuality
GTTTCTACAAGGCTCC-1	GoodQuality
GTTTCTACACGGTGTC-1	LowQuality
GTTTCTACATATGAGA-1	LowQuality
GTTTCTACATCGTCGG-1	GoodQuality
GTTTCTAGTACCGGCT-1	LowQuality
GTTTCTAGTCCTGCTT-1	GoodQuality
GTTTCTATCAAGCCTA-1	LowQuality
GTTTCTATCATCGATG-1	GoodQuality
GTTTCTATCATGTGGT-1	GoodQuality
GTTTCTATCCTATGTT-1	LowQuality
GTTTCTATCGGTCTAA-1	GoodQuality
GTTTCTATCTCGGACG-1	GoodQuality
GTTTCTATCTGCGACG-1	GoodQuality
TAAACCGAGAGCTGCA-1	LowQuality
TAAACCGAGGCTACGA-1	LowQuality
TAAACCGAGTATGACA-1	GoodQuality
TAAACCGCAAATACAG-1	LowQuality
TAAACCGCAATGACCT-1	LowQuality
TAAACCGCACAAGTAA-1	GoodQuality
TAAACCGCAGAAGCAC-1	LowQuality
TAAACCGGTAAACCTC-1	GoodQuality
TAAACCGGTCCGACGT-1	LowQuality
TAAACCGTCAACGGGA-1	GoodQuality
TAAACCGTCCGTCAAA-1	GoodQuality
TAAACCGTCGAGCCCA-1	LowQuality
TAAGAGAAGCATGGCA-1	LowQuality
TAAGAGAAGCCCTAAT-1	GoodQuality
TAAGAGAAGCTTTGGT-1	LowQuality
TAAGAGAAGGATTCGG-1	GoodQuality
TAAGAGAAGGCCGAAT-1	LowQuality
TAAGAGAAGTCTTGCA-1	GoodQuality
TAAGAGAAGTGCAAGC-1	LowQuality
TAAGAGAAGTTGCAGG-1	LowQuality
TAAGAGACACATCCAA-1	GoodQuality
TAAGAGACACTTACGA-1	GoodQuality
TAAGAGACAGATCGGA-1	GoodQuality
TAAGAGACATATGGTC-1	GoodQuality
TAAGAGACATTACGAC-1	LowQuality
TAAGAGAGTGATGCCC-1	LowQuality
TAAGAGATCACAATGC-1	GoodQuality
TAAGAGATCCCTCTTT-1	GoodQuality
TAAGCGTAGAGACTAT-1	GoodQuality
TAAGCGTAGAGAGCTC-1	GoodQuality
TAAGCGTAGATCGGGT-1	LowQuality
TAAGCGTAGCACACAG-1	GoodQuality
TAAGCGTAGGAGTAGA-1	GoodQuality
TAAGCGTAGTTTGCGT-1	GoodQuality
TAAGCGTCACAGGTTT-1	GoodQuality
TAAGCGTCACTGTTAG-1	LowQuality
TAAGCGTCAGGGTATG-1	LowQuality
TAAGCGTCATTTCAGG-1	GoodQuality
TAAGCGTGTGCGAAAC-1	GoodQuality
TAAGCGTGTGTAAGTA-1	LowQuality
TAAGCGTTCGGTGTTA-1	GoodQuality
TAAGTGCAGAACAACT-1	GoodQuality
TAAGTGCCAAGACGTG-1	GoodQuality
TAAGTGCCACAACGCC-1	LowQuality
TAAGTGCCAGCTGGCT-1	LowQuality
TAAGTGCGTCCAGTAT-1	LowQuality
TAAGTGCGTCGATTGT-1	GoodQuality
TAAGTGCGTGAGTGAC-1	GoodQuality
TAAGTGCTCACAGTAC-1	GoodQuality
TAAGTGCTCGAGAACG-1	LowQuality
TAAGTGCTCGCAGGCT-1	GoodQuality
TAAGTGCTCTGACCTC-1	GoodQuality
TAAGTGCTCTTAACCT-1	LowQuality
TACACGAAGTGCCATT-1	GoodQuality
TACACGACAAGGCTCC-1	LowQuality
TACACGACACCACCAG-1	GoodQuality
TACACGACACCCAGTG-1	GoodQuality
TACACGACACCGAATT-1	GoodQuality
TACACGACACCTCGTT-1	GoodQuality
TACACGACATGCTAGT-1	LowQuality
TACACGAGTAAATACG-1	GoodQuality
TACACGAGTAAGGGCT-1	GoodQuality
TACACGAGTACAGTTC-1	GoodQuality
TACACGAGTATATGGA-1	GoodQuality
TACACGAGTATTACCG-1	GoodQuality
TACACGAGTCCGACGT-1	GoodQuality
TACACGAGTCCTCTTG-1	GoodQuality
TACACGAGTCTACCTC-1	GoodQuality
TACACGATCCCTCAGT-1	LowQuality
TACACGATCGTACGGC-1	LowQuality
TACACGATCTGTTGAG-1	GoodQuality
TACAGTGAGAACTGTA-1	GoodQuality
TACAGTGAGCGAAGGG-1	LowQuality
TACAGTGCAAACTGCT-1	GoodQuality
TACAGTGCATATACCG-1	GoodQuality
TACAGTGGTAGAGGAA-1	LowQuality
TACAGTGGTGAGTATA-1	GoodQuality
TACAGTGGTGCCTGGT-1	GoodQuality
TACAGTGTCCAGGGCT-1	GoodQuality
TACCTATAGCCGGTAA-1	GoodQuality
TACCTATCATAGAAAC-1	GoodQuality
TACCTATGTCAGAAGC-1	GoodQuality
TACCTATGTCCGTTAA-1	GoodQuality
TACCTATTCAACACAC-1	GoodQuality
TACCTATTCTGTTGAG-1	GoodQuality
TACCTATTCTTGCCGT-1	GoodQuality
TACCTTAAGAGTAATC-1	GoodQuality
TACCTTAAGCGTAGTG-1	LowQuality
TACCTTAAGTGGTCCC-1	GoodQuality
TACCTTACAAGAAGAG-1	LowQuality
TACCTTACAATGAATG-1	LowQuality
TACCTTACACAGAGGT-1	GoodQuality
TACCTTACATAGGATA-1	GoodQuality
TACCTTACATGCCCGA-1	GoodQuality
TACCTTAGTCCCGACA-1	GoodQuality
TACCTTAGTTACCGAT-1	GoodQuality
TACCTTATCACCACCT-1	GoodQuality
TACCTTATCATAGCAC-1	LowQuality
TACCTTATCCTACAGA-1	GoodQuality
TACCTTATCGGCGCTA-1	GoodQuality
TACCTTATCTCGATGA-1	LowQuality
TACGGATAGCCACCTG-1	GoodQuality
TACGGATAGCCTTGAT-1	GoodQuality
TACGGATAGCTAGTTC-1	GoodQuality
TACGGATCACAGTCGC-1	GoodQuality
TACGGATCAGACGTAG-1	GoodQuality
TACGGATCAGGGTTAG-1	LowQuality
TACGGATCATGCGCAC-1	LowQuality
TACGGATGTAAAGTCA-1	GoodQuality
TACGGATGTAGTAGTA-1	GoodQuality
TACGGATGTATAAACG-1	GoodQuality
TACGGATGTCCGACGT-1	LowQuality
TACGGATGTCTAGCGC-1	LowQuality
TACGGATGTCTGATTG-1	GoodQuality
TACGGATTCACCTTAT-1	GoodQuality
TACGGATTCCGGGTGT-1	GoodQuality
TACGGATTCTTTACGT-1	GoodQuality
TACGGGCCACCAGATT-1	GoodQuality
TACGGGCCAGACAGGT-1	GoodQuality
TACGGGCCAGCCAGAA-1	GoodQuality
TACGGGCCATGCTAGT-1	GoodQuality
TACGGGCGTAAAGGAG-1	GoodQuality
TACGGGCGTAGCAAAT-1	GoodQuality
TACGGGCTCAACCATG-1	LowQuality
TACGGGCTCTTCGAGA-1	GoodQuality
TACGGTAAGAGGTACC-1	LowQuality
TACGGTACAAGAAGAG-1	LowQuality
TACGGTACACATTCGA-1	GoodQuality
TACGGTACACTTCGAA-1	GoodQuality
TACGGTACAGATGGGT-1	LowQuality
TACGGTACAGGCGATA-1	GoodQuality
TACGGTACATCCGTGG-1	GoodQuality
TACGGTACATTAGGCT-1	GoodQuality
TACGGTAGTGACGCCT-1	LowQuality
TACGGTAGTGGCCCTA-1	GoodQuality
TACGGTAGTTACGGAG-1	GoodQuality
TACGGTAGTTGGACCC-1	LowQuality
TACGGTATCCTTCAAT-1	GoodQuality
TACGGTATCTGGTTCC-1	GoodQuality
TACTCATAGTAGGCCA-1	GoodQuality
TACTCATAGTCCCACG-1	GoodQuality
TACTCATAGTGCCATT-1	LowQuality
TACTCATCAATAACGA-1	GoodQuality
TACTCATCACGAAAGC-1	GoodQuality
TACTCATCATGTAGTC-1	GoodQuality
TACTCATGTAAGTAGT-1	GoodQuality
TACTCATGTCTTCGTC-1	GoodQuality
TACTCATGTGGAAAGA-1	LowQuality
TACTCATTCGTCGTTC-1	GoodQuality
TACTCATTCTCTGCTG-1	GoodQuality
TACTCGCAGACCTAGG-1	GoodQuality
TACTCGCAGGAGCGAG-1	GoodQuality
TACTCGCAGGAGTAGA-1	GoodQuality
TACTCGCAGTGCGTGA-1	GoodQuality
TACTCGCCAAATACAG-1	GoodQuality
TACTCGCGTAAATACG-1	LowQuality
TACTCGCGTCTGCGGT-1	GoodQuality
TACTCGCGTTAAAGTG-1	LowQuality
TACTCGCGTTATCACG-1	GoodQuality
TACTCGCTCAGTCAGT-1	LowQuality
TACTCGCTCCCACTTG-1	LowQuality
TACTCGCTCCGTACAA-1	GoodQuality
TACTCGCTCGGAGGTA-1	GoodQuality
TACTCGCTCTAACTCT-1	GoodQuality
TACTCGCTCTCCGGTT-1	LowQuality
TACTTACAGGATGGTC-1	GoodQuality
TACTTACAGGATGTAT-1	GoodQuality
TACTTACAGGCCATAG-1	LowQuality
TACTTACAGTGGGCTA-1	LowQuality
TACTTACAGTGTTAGA-1	GoodQuality
TACTTACCAAAGAATC-1	GoodQuality
TACTTACCAAGTAGTA-1	LowQuality
TACTTACCACGGATAG-1	LowQuality
TACTTACCAGCCTATA-1	LowQuality
TACTTACCAGTGAGTG-1	LowQuality
TACTTACCATGAAGTA-1	GoodQuality
TACTTACGTAAATGAC-1	GoodQuality
TACTTACGTCTGATTG-1	LowQuality
TACTTACGTGTTGGGA-1	LowQuality
TACTTACGTTTCGCTC-1	GoodQuality
TACTTACTCCACGCAG-1	LowQuality
TACTTGTAGAATAGGG-1	GoodQuality
TACTTGTAGCACGCCT-1	GoodQuality
TACTTGTAGTGTTGAA-1	GoodQuality
TACTTGTCAATCAGAA-1	LowQuality
TACTTGTCAATGACCT-1	GoodQuality
TACTTGTCACATCTTT-1	LowQuality
TACTTGTCACTCGACG-1	GoodQuality
TACTTGTCAGCTTAAC-1	LowQuality
TACTTGTCAGGACGTA-1	GoodQuality
TACTTGTCATAAGACA-1	GoodQuality
TACTTGTGTAAGTTCC-1	GoodQuality
TACTTGTGTAGCTTGT-1	GoodQuality
TACTTGTGTCCAGTAT-1	GoodQuality
TACTTGTGTTACTGAC-1	GoodQuality
TACTTGTTCGTCCGTT-1	GoodQuality
TACTTGTTCTCAAGTG-1	LowQuality
TACTTGTTCTGGTATG-1	GoodQuality
TAGACCAAGACTAAGT-1	GoodQuality
TAGACCAAGAGCTGCA-1	GoodQuality
TAGACCAAGCCCAATT-1	GoodQuality
TAGACCACAACACGCC-1	GoodQuality
TAGACCACAATCACAC-1	GoodQuality
TAGACCACAATGAAAC-1	GoodQuality
TAGACCACACCATCCT-1	GoodQuality
TAGACCACATTCACTT-1	GoodQuality
TAGACCAGTGACTACT-1	LowQuality
TAGACCAGTGATGTCT-1	GoodQuality
TAGAGCTAGGACGAAA-1	GoodQuality
TAGAGCTCAAGTAATG-1	GoodQuality
TAGAGCTGTAAATACG-1	GoodQuality
TAGAGCTGTACCAGTT-1	GoodQuality
TAGAGCTGTATCGCAT-1	GoodQuality
TAGAGCTGTTAAGATG-1	LowQuality
TAGAGCTTCAGTCAGT-1	GoodQuality
TAGAGCTTCCACGACG-1	LowQuality
TAGAGCTTCTGCTGCT-1	LowQuality
TAGCCGGAGACAAAGG-1	GoodQuality
TAGCCGGAGAGTCGGT-1	GoodQuality
TAGCCGGAGGATGGTC-1	LowQuality
TAGCCGGAGTTCCACA-1	GoodQuality
TAGCCGGCAGCGAACA-1	GoodQuality
TAGCCGGCAGGATTGG-1	GoodQuality
TAGCCGGCATGGATGG-1	GoodQuality
TAGCCGGCATTGGTAC-1	GoodQuality
TAGCCGGGTAAAGTCA-1	LowQuality
TAGCCGGGTCCTAGCG-1	GoodQuality
TAGCCGGGTGCCTGCA-1	LowQuality
TAGCCGGGTGGCGAAT-1	LowQuality
TAGCCGGGTGTGCCTG-1	GoodQuality
TAGCCGGGTTTGACAC-1	GoodQuality
TAGCCGGTCTGCGGCA-1	GoodQuality
TAGCCGGTCTTCAACT-1	LowQuality
TAGGCATAGACTGTAA-1	LowQuality
TAGGCATAGCAAATCA-1	GoodQuality
TAGGCATAGTACGACG-1	GoodQuality
TAGGCATAGTTCCACA-1	LowQuality
TAGGCATCAAAGCGGT-1	LowQuality
TAGGCATCAAAGTGCG-1	LowQuality
TAGGCATCAATCGAAA-1	GoodQuality
TAGGCATCACCGCTAG-1	LowQuality
TAGGCATCACGACTCG-1	GoodQuality
TAGGCATGTTGGGACA-1	LowQuality
TAGGCATTCATATCGG-1	GoodQuality
TAGGCATTCCCTCTTT-1	GoodQuality
TAGGCATTCCCTTGCA-1	LowQuality
TAGGCATTCCGCGGTA-1	GoodQuality
TAGTGGTAGGAGTTTA-1	GoodQuality
TAGTGGTAGGTGTTAA-1	GoodQuality
TAGTGGTCAAACCCAT-1	LowQuality
TAGTGGTCACCGAAAG-1	LowQuality
TAGTGGTCACGACGAA-1	GoodQuality
TAGTGGTCAGACGTAG-1	LowQuality
TAGTGGTCATCCGCGA-1	GoodQuality
TAGTGGTGTGTTTGGT-1	GoodQuality
TAGTTGGAGCGTTGCC-1	GoodQuality
TAGTTGGAGGATGGAA-1	LowQuality
TAGTTGGAGGGATGGG-1	GoodQuality
TAGTTGGAGTCCTCCT-1	LowQuality
TAGTTGGCAAGTAGTA-1	GoodQuality
TAGTTGGCACGGACAA-1	GoodQuality
TAGTTGGCACTGTCGG-1	GoodQuality
TAGTTGGCAGACGCAA-1	LowQuality
TAGTTGGCAGTGGAGT-1	GoodQuality
TAGTTGGCATCACAAC-1	GoodQuality
TAGTTGGCATCCGTGG-1	GoodQuality
TAGTTGGCATCTGGTA-1	GoodQuality
TAGTTGGGTGAAAGAG-1	LowQuality
TAGTTGGTCAGTTTGG-1	GoodQuality
TAGTTGGTCCGTTGTC-1	GoodQuality
TAGTTGGTCTTCCTTC-1	GoodQuality
TATCAGGAGAAAGTGG-1	GoodQuality
TATCAGGAGAAGGACA-1	GoodQuality
TATCAGGAGACGCAAC-1	GoodQuality
TATCAGGAGACTTGAA-1	LowQuality
TATCAGGCAGCTGTTA-1	GoodQuality
TATCAGGCATAGAAAC-1	GoodQuality
TATCAGGCATTTGCCC-1	GoodQuality
TATCAGGGTAGGGACT-1	GoodQuality
TATCAGGGTGTGACCC-1	LowQuality
TATCAGGGTTACGCGC-1	LowQuality
TATCAGGTCAGAGACG-1	GoodQuality
TATCAGGTCCACGTTC-1	GoodQuality
TATCTCAAGAGGTTAT-1	GoodQuality
TATCTCAAGCCTCGTG-1	GoodQuality
TATCTCAAGGGCTTGA-1	GoodQuality
TATCTCAAGTAATCCC-1	LowQuality
TATCTCAAGTGGGCTA-1	LowQuality
TATCTCAAGTGTACCT-1	GoodQuality
TATCTCAGTAATAGCA-1	LowQuality
TATCTCAGTCTGGTCG-1	GoodQuality
TATCTCAGTTCCAACA-1	GoodQuality
TATCTCAGTTGTACAC-1	GoodQuality
TATGCCCAGTGCCAGA-1	GoodQuality
TATGCCCCAATCGGTT-1	GoodQuality
TATGCCCCAGTATCTG-1	GoodQuality
TATGCCCCATCCGGGT-1	GoodQuality
TATGCCCCATGTCCTC-1	GoodQuality
TATGCCCGTAATTGGA-1	GoodQuality
TATGCCCGTACTCGCG-1	GoodQuality
TATGCCCTCAACACCA-1	GoodQuality
TATGCCCTCCGTTGTC-1	LowQuality
TATGCCCTCGCTTAGA-1	GoodQuality
TATGCCCTCTGCGGCA-1	LowQuality
TATTACCAGGATTCGG-1	GoodQuality
TATTACCAGTCCATAC-1	LowQuality
TATTACCAGTGAAGAG-1	GoodQuality
TATTACCCAAACGTGG-1	LowQuality
TATTACCCATGACGGA-1	LowQuality
TATTACCGTAAGTAGT-1	LowQuality
TATTACCGTATCACCA-1	LowQuality
TATTACCGTCGCGAAA-1	GoodQuality
TATTACCGTCTCGTTC-1	LowQuality
TATTACCGTCTGGTCG-1	GoodQuality
TATTACCGTCTTGCGG-1	LowQuality
TATTACCGTTATCACG-1	GoodQuality
TATTACCGTTATCGGT-1	GoodQuality
TATTACCGTTGGACCC-1	LowQuality
TATTACCTCAGCCTAA-1	GoodQuality
TATTACCTCCCTAATT-1	LowQuality
TCAACGAAGTGAACAT-1	LowQuality
TCAACGACACGCGAAA-1	GoodQuality
TCAACGACAGTCAGAG-1	LowQuality
TCAACGACAGTTCATG-1	GoodQuality
TCAACGAGTAAACGCG-1	GoodQuality
TCAACGATCAATCACG-1	GoodQuality
TCAACGATCACATAGC-1	GoodQuality
TCAACGATCCACGTGG-1	GoodQuality
TCAACGATCCATGAAC-1	LowQuality
TCAACGATCCTGCTTG-1	GoodQuality
TCAATCTAGCGGATCA-1	GoodQuality
TCAATCTAGGAGCGAG-1	GoodQuality
TCAATCTAGGCTACGA-1	GoodQuality
TCAATCTCAATCGAAA-1	GoodQuality
TCAATCTCACTTAACG-1	LowQuality
TCAATCTCAGGGATTG-1	GoodQuality
TCAATCTCAGTCAGAG-1	GoodQuality
TCAATCTCATTCTTAC-1	GoodQuality
TCAATCTGTTCCGGCA-1	GoodQuality
TCAATCTTCAGGTTCA-1	GoodQuality
TCAATCTTCATCACCC-1	GoodQuality
TCAATCTTCGACCAGC-1	GoodQuality
TCAATCTTCGAGGTAG-1	GoodQuality
TCAATCTTCGCGTTTC-1	GoodQuality
TCAATCTTCTAAGCCA-1	GoodQuality
TCACAAGAGCCAGTTT-1	LowQuality
TCACAAGAGCTAGGCA-1	GoodQuality
TCACAAGAGGCTCATT-1	LowQuality
TCACAAGAGTACGACG-1	LowQuality
TCACAAGAGTGGGTTG-1	GoodQuality
TCACAAGGTAGCGTGA-1	GoodQuality
TCACAAGGTCGCATAT-1	GoodQuality
TCACAAGTCAACGGCC-1	GoodQuality
TCACAAGTCCATGAAC-1	LowQuality
TCACGAAAGAAACGAG-1	GoodQuality
TCACGAAAGACGCTTT-1	GoodQuality
TCACGAAAGATCCCGC-1	GoodQuality
TCACGAAAGGAGTACC-1	LowQuality
TCACGAACACGAGGTA-1	GoodQuality
TCACGAACAGCCTATA-1	GoodQuality
TCACGAACAGGCTCAC-1	GoodQuality
TCACGAACAGTACACT-1	GoodQuality
TCACGAACATTTCACT-1	GoodQuality
TCACGAAGTGCGATAG-1	LowQuality
TCACGAAGTGTGAATA-1	LowQuality
TCACGAATCAGGTAAA-1	GoodQuality
TCACGAATCTCATTCA-1	GoodQuality
TCAGATGAGATAGCAT-1	LowQuality
TCAGATGAGATAGTCA-1	LowQuality
TCAGATGAGCGTCTAT-1	GoodQuality
TCAGATGAGGTGGGTT-1	GoodQuality
TCAGATGCAAATCCGT-1	LowQuality
TCAGATGCAAGCGAGT-1	LowQuality
TCAGATGCAAGGTTTC-1	LowQuality
TCAGATGCACAACGCC-1	LowQuality
TCAGATGCACATCTTT-1	GoodQuality
TCAGATGCAGGAACGT-1	GoodQuality
TCAGATGCATAAGACA-1	GoodQuality
TCAGATGGTAAACACA-1	LowQuality
TCAGATGGTATTAGCC-1	GoodQuality
TCAGATGGTCGACTGC-1	GoodQuality
TCAGATGGTCGGATCC-1	GoodQuality
TCAGATGGTCTCATCC-1	GoodQuality
TCAGATGGTCTTGATG-1	LowQuality
TCAGATGGTGTTCGAT-1	GoodQuality
TCAGATGGTTCAGACT-1	GoodQuality
TCAGATGGTTCCAACA-1	GoodQuality
TCAGATGTCACATAGC-1	GoodQuality
TCAGATGTCGGTCTAA-1	LowQuality
TCAGCAAAGAAACCGC-1	LowQuality
TCAGCAAAGATCCTGT-1	GoodQuality
TCAGCAAAGATGTGGC-1	GoodQuality
TCAGCAAAGGACGAAA-1	GoodQuality
TCAGCAAAGTTGTCGT-1	GoodQuality
TCAGCAACACAAGCCC-1	GoodQuality
TCAGCAACACGCTTTC-1	GoodQuality
TCAGCAACAGATCCAT-1	GoodQuality
TCAGCAACATTTGCCC-1	LowQuality
TCAGCAAGTACGACCC-1	GoodQuality
TCAGCAAGTCGACTGC-1	GoodQuality
TCAGCTCAGTACGACG-1	LowQuality
TCAGCTCAGTCGTTTG-1	GoodQuality
TCAGCTCGTATTCTCT-1	GoodQuality
TCAGCTCGTCAATGTC-1	GoodQuality
TCAGCTCGTCGCGAAA-1	GoodQuality
TCAGCTCGTGCCTGCA-1	GoodQuality
TCAGCTCGTGTTTGTG-1	GoodQuality
TCAGCTCTCACAAACC-1	GoodQuality
TCAGCTCTCAGCTCGG-1	LowQuality
TCAGCTCTCCCATTTA-1	GoodQuality
TCAGCTCTCGGAGCAA-1	GoodQuality
TCAGGATAGCGTGTCC-1	GoodQuality
TCAGGATCACCTATCC-1	GoodQuality
TCAGGATCAGAGCCAA-1	LowQuality
TCAGGATGTGTGTGCC-1	GoodQuality
TCAGGATGTTACGCGC-1	GoodQuality
TCAGGATTCCAAGTAC-1	LowQuality
TCAGGATTCGAACGGA-1	GoodQuality
TCAGGTAAGACAAGCC-1	LowQuality
TCAGGTAAGTTCGCGC-1	GoodQuality
TCAGGTAGTAGCCTAT-1	GoodQuality
TCAGGTAGTCATATGC-1	GoodQuality
TCAGGTAGTCATTAGC-1	LowQuality
TCAGGTAGTCTTCTCG-1	LowQuality
TCAGGTAGTGAAAGAG-1	LowQuality
TCAGGTAGTGCGCTTG-1	LowQuality
TCAGGTAGTGGTACAG-1	GoodQuality
TCAGGTAGTTACAGAA-1	GoodQuality
TCAGGTAGTTGCCTCT-1	GoodQuality
TCATTACCAGATTGCT-1	GoodQuality
TCATTACCAGTCGTGC-1	GoodQuality
TCATTACCATGCTGGC-1	LowQuality
TCATTACGTAGCGTGA-1	LowQuality
TCATTACGTATATGAG-1	GoodQuality
TCATTACGTATCGCAT-1	LowQuality
TCATTACGTCAGCTAT-1	GoodQuality
TCATTACGTTAGGGTG-1	LowQuality
TCATTACTCAGCAACT-1	GoodQuality
TCATTACTCATCGCTC-1	GoodQuality
TCATTACTCCGAAGAG-1	GoodQuality
TCATTACTCTCCAGGG-1	GoodQuality
TCATTACTCTGATTCT-1	LowQuality
TCATTTGAGCGATATA-1	GoodQuality
TCATTTGAGCGATGAC-1	GoodQuality
TCATTTGAGCGCTCCA-1	GoodQuality
TCATTTGAGGGCTTCC-1	LowQuality
TCATTTGAGTGAACGC-1	GoodQuality
TCATTTGCAAGTTAAG-1	GoodQuality
TCATTTGCAGCTGGCT-1	LowQuality
TCATTTGCATCGGAAG-1	LowQuality
TCATTTGGTACACCGC-1	GoodQuality
TCATTTGGTCGCTTTC-1	GoodQuality
TCATTTGGTCTTGTCC-1	LowQuality
TCATTTGGTGTATGGG-1	LowQuality
TCATTTGTCAGGTTCA-1	LowQuality
TCATTTGTCCTATGTT-1	LowQuality
TCATTTGTCGTTTGCC-1	LowQuality
TCCACACAGCTACCGC-1	GoodQuality
TCCACACCACTCAGGC-1	GoodQuality
TCCACACCATTGGCGC-1	GoodQuality
TCCACACGTCAAAGCG-1	LowQuality
TCCACACTCACAGGCC-1	GoodQuality
TCCACACTCCGTTGCT-1	GoodQuality
TCCACACTCGTGACAT-1	LowQuality
TCCACACTCTACCTGC-1	GoodQuality
TCCACACTCTTTAGTC-1	LowQuality
TCCCGATAGATGTGGC-1	LowQuality
TCCCGATAGTAACCCT-1	GoodQuality
TCCCGATAGTACGTTC-1	GoodQuality
TCCCGATAGTGATCGG-1	GoodQuality
TCCCGATCAGCGTCCA-1	GoodQuality
TCCCGATCATATGCTG-1	GoodQuality
TCCCGATCATCCTAGA-1	GoodQuality
TCCCGATGTAGAGTGC-1	LowQuality
TCCCGATGTAGTAGTA-1	GoodQuality
TCCCGATGTGTGCGTC-1	GoodQuality
TCCCGATTCTTGAGAC-1	GoodQuality
TCGAGGCAGAGTGAGA-1	GoodQuality
TCGAGGCAGTGCCAGA-1	GoodQuality
TCGAGGCCAAGAAAGG-1	GoodQuality
TCGAGGCCAAGTTAAG-1	GoodQuality
TCGAGGCCACGCTTTC-1	GoodQuality
TCGAGGCGTAGCCTCG-1	GoodQuality
TCGAGGCGTATGGTTC-1	GoodQuality
TCGAGGCGTTCAGCGC-1	GoodQuality
TCGAGGCTCAAGGTAA-1	LowQuality
TCGAGGCTCACAAACC-1	LowQuality
TCGAGGCTCCCATTTA-1	LowQuality
TCGAGGCTCTGTTGAG-1	GoodQuality
TCGCGAGAGAAACGCC-1	GoodQuality
TCGCGAGAGGCTCATT-1	GoodQuality
TCGCGAGAGTGGGCTA-1	LowQuality
TCGCGAGCAATCCAAC-1	GoodQuality
TCGCGAGCAGATCGGA-1	GoodQuality
TCGCGAGCATTCTCAT-1	GoodQuality
TCGCGAGGTGTTTGGT-1	GoodQuality
TCGCGAGTCCACTCCA-1	LowQuality
TCGCGTTAGAACAATC-1	LowQuality
TCGCGTTCACACATGT-1	GoodQuality
TCGCGTTCACCTCGTT-1	LowQuality
TCGCGTTCATCATCCC-1	LowQuality
TCGCGTTGTAAGCACG-1	GoodQuality
TCGCGTTGTCCAAGTT-1	GoodQuality
TCGCGTTGTTATCACG-1	GoodQuality
TCGCGTTTCCCATTTA-1	GoodQuality
TCGCGTTTCTCCAGGG-1	GoodQuality
TCGGGACAGAACAACT-1	GoodQuality
TCGGGACAGAGTCTGG-1	GoodQuality
TCGGGACAGGAACTGC-1	LowQuality
TCGGGACAGTGTACCT-1	GoodQuality
TCGGGACCAAGCCGTC-1	GoodQuality
TCGGGACCACGAGGTA-1	LowQuality
TCGGGACCAGCAGTTT-1	GoodQuality
TCGGGACCAGTCAGCC-1	GoodQuality
TCGGGACGTACGACCC-1	GoodQuality
TCGGGACGTTGCGCAC-1	LowQuality
TCGGGACTCCAGTAGT-1	GoodQuality
TCGGGACTCGAACGGA-1	GoodQuality
TCGGGACTCGTTACGA-1	GoodQuality
TCGGGACTCTGGCGTG-1	LowQuality
TCGGTAAAGAGTAATC-1	LowQuality
TCGGTAAAGAGTACCG-1	GoodQuality
TCGGTAAAGGCTAGAC-1	GoodQuality
TCGGTAAAGTTCCACA-1	LowQuality
TCGGTAAGTAGAAGGA-1	GoodQuality
TCGGTAAGTAGGGACT-1	GoodQuality
TCGGTAAGTCCGAAGA-1	LowQuality
TCGGTAAGTCGCGTGT-1	LowQuality
TCGGTAAGTGCTGTAT-1	GoodQuality
TCGGTAATCTCCAGGG-1	GoodQuality
TCGGTAATCTCGAGTA-1	GoodQuality
TCGTACCAGTAGTGCG-1	GoodQuality
TCGTACCCAATACGCT-1	GoodQuality
TCGTACCCATACGCTA-1	GoodQuality
TCGTACCGTCCTGCTT-1	GoodQuality
TCGTACCGTGAGCGAT-1	GoodQuality
TCGTACCGTGGTCCGT-1	GoodQuality
TCGTACCGTTGCGCAC-1	GoodQuality
TCGTACCTCACGGTTA-1	LowQuality
TCGTACCTCCGTAGTA-1	GoodQuality
TCGTACCTCGTCGTTC-1	GoodQuality
TCGTAGAAGCATCATC-1	GoodQuality
TCGTAGAAGCTAAGAT-1	GoodQuality
TCGTAGAAGCTGTTCA-1	GoodQuality
TCGTAGAAGGACAGAA-1	LowQuality
TCGTAGAAGTGACATA-1	GoodQuality
TCGTAGAAGTTGAGTA-1	GoodQuality
TCGTAGACACTGTCGG-1	GoodQuality
TCGTAGACAGGAATCG-1	LowQuality
TCGTAGACAGTGAGTG-1	LowQuality
TCGTAGACATACGCCG-1	GoodQuality
TCGTAGACATATACGC-1	GoodQuality
TCGTAGAGTGAGCGAT-1	GoodQuality
TCGTAGAGTGCAGTAG-1	GoodQuality
TCGTAGAGTTGAACTC-1	GoodQuality
TCGTAGATCAGAAATG-1	GoodQuality
TCGTAGATCCCAAGAT-1	GoodQuality
TCGTAGATCCGGGTGT-1	GoodQuality
TCGTAGATCGCAAACT-1	LowQuality
TCGTAGATCGTACCGG-1	GoodQuality
TCGTAGATCTAACTTC-1	GoodQuality
TCGTAGATCTTTACAC-1	GoodQuality
TCTATTGAGCAAATCA-1	GoodQuality
TCTATTGAGCAACGGT-1	GoodQuality
TCTATTGAGGCGCTCT-1	GoodQuality
TCTATTGAGTACACCT-1	GoodQuality
TCTATTGCAAGTTCTG-1	GoodQuality
TCTATTGCACCAGTTA-1	LowQuality
TCTATTGCACGTCTCT-1	GoodQuality
TCTATTGCAGTAAGCG-1	GoodQuality
TCTATTGCAGTCACTA-1	GoodQuality
TCTATTGCATCTGGTA-1	LowQuality
TCTATTGCATGACATC-1	GoodQuality
TCTATTGGTACGCTGC-1	GoodQuality
TCTATTGGTATAGTAG-1	LowQuality
TCTATTGGTCTCACCT-1	GoodQuality
TCTATTGTCGGATGGA-1	LowQuality
TCTCATAAGACGCAAC-1	GoodQuality
TCTCATAAGCCTATGT-1	LowQuality
TCTCATACAATGTTGC-1	LowQuality
TCTCATACATGGTTGT-1	GoodQuality
TCTCATAGTACCGAGA-1	GoodQuality
TCTCATAGTCAATACC-1	GoodQuality
TCTCATAGTCGCGAAA-1	LowQuality
TCTCATAGTTCGTGAT-1	GoodQuality
TCTCATAGTTTGGGCC-1	GoodQuality
TCTCATATCACGCATA-1	GoodQuality
TCTCATATCATGCTCC-1	GoodQuality
TCTCTAAAGAAAGTGG-1	GoodQuality
TCTCTAAAGCCTATGT-1	GoodQuality
TCTCTAAAGTACACCT-1	GoodQuality
TCTCTAAAGTGACTCT-1	LowQuality
TCTCTAACACCATCCT-1	GoodQuality
TCTCTAACAGATGGCA-1	LowQuality
TCTCTAACATCCGGGT-1	GoodQuality
TCTCTAAGTCTGCAAT-1	GoodQuality
TCTCTAAGTGTGAAAT-1	GoodQuality
TCTCTAAGTTGTCGCG-1	GoodQuality
TCTCTAATCGAACTGT-1	GoodQuality
TCTCTAATCGCGTTTC-1	GoodQuality
TCTGAGAAGTTGCAGG-1	GoodQuality
TCTGAGACAAGCTGAG-1	GoodQuality
TCTGAGACACAGGCCT-1	GoodQuality
TCTGAGACATATACGC-1	GoodQuality
TCTGAGACATGACGGA-1	GoodQuality
TCTGAGAGTAGCACGA-1	GoodQuality
TCTGAGAGTCGGATCC-1	LowQuality
TCTGAGAGTGTAACGG-1	GoodQuality
TCTGAGATCATGCAAC-1	LowQuality
TCTGAGATCGTGGGAA-1	GoodQuality
TCTGAGATCTGGCGTG-1	GoodQuality
TCTGGAAAGTGCGATG-1	GoodQuality
TCTGGAACACACATGT-1	LowQuality
TCTGGAACATGAACCT-1	LowQuality
TCTGGAAGTAAGTGGC-1	GoodQuality
TCTGGAAGTCACACGC-1	GoodQuality
TCTGGAAGTTATGTGC-1	GoodQuality
TCTGGAATCCGCGTTT-1	LowQuality
TCTGGAATCGGAGGTA-1	GoodQuality
TCTGGAATCTCAAGTG-1	LowQuality
TCTGGAATCTTAGCCC-1	GoodQuality
TCTTCGGAGAGCCTAG-1	LowQuality
TCTTCGGAGCTAGTCT-1	GoodQuality
TCTTCGGAGTCGATAA-1	GoodQuality
TCTTCGGAGTGGGTTG-1	LowQuality
TCTTCGGAGTTGAGTA-1	GoodQuality
TCTTCGGCAATCGGTT-1	GoodQuality
TCTTCGGCACAACGTT-1	GoodQuality
TCTTCGGCAGCGAACA-1	GoodQuality
TCTTCGGCAGGGAGAG-1	GoodQuality
TCTTCGGCATAAGACA-1	GoodQuality
TCTTCGGGTACTCAAC-1	GoodQuality
TCTTCGGGTCGAAAGC-1	LowQuality
TCTTCGGGTCTTGATG-1	LowQuality
TCTTCGGGTTATCGGT-1	GoodQuality
TCTTCGGGTTTAGCTG-1	GoodQuality
TCTTCGGTCAAGGCTT-1	GoodQuality
TCTTCGGTCCTAGAAC-1	GoodQuality
TCTTCGGTCCTCAATT-1	LowQuality
TCTTCGGTCGCATGGC-1	GoodQuality
TCTTCGGTCGGTTCGG-1	LowQuality
TCTTTCCAGCGATCCC-1	GoodQuality
TCTTTCCAGGATGCGT-1	GoodQuality
TCTTTCCAGGCTCTTA-1	GoodQuality
TCTTTCCAGTAAGTAC-1	GoodQuality
TCTTTCCAGTTGTCGT-1	LowQuality
TCTTTCCCACTAAGTC-1	LowQuality
TCTTTCCCAGGAATCG-1	GoodQuality
TCTTTCCCATTAGCCA-1	GoodQuality
TCTTTCCGTATAGGGC-1	GoodQuality
TCTTTCCGTGCAGTAG-1	GoodQuality
TCTTTCCGTTTGGCGC-1	GoodQuality
TCTTTCCTCCGCGGTA-1	LowQuality
TCTTTCCTCCTATTCA-1	GoodQuality
TCTTTCCTCCTTGGTC-1	GoodQuality
TCTTTCCTCTACCAGA-1	LowQuality
TGAAAGAAGCTCTCGG-1	GoodQuality
TGAAAGAAGTACGTTC-1	GoodQuality
TGAAAGACACAGAGGT-1	GoodQuality
TGAAAGACATAGAAAC-1	LowQuality
TGAAAGAGTATGAAAC-1	LowQuality
TGAAAGAGTCCGAATT-1	GoodQuality
TGAAAGAGTCCGAGTC-1	LowQuality
TGAAAGAGTTCAGTAC-1	LowQuality
TGAAAGATCCCTTGTG-1	GoodQuality
TGAAAGATCTCAACTT-1	GoodQuality
TGAAAGATCTCGTTTA-1	LowQuality
TGACAACAGAATGTGT-1	GoodQuality
TGACAACCACACTGCG-1	GoodQuality
TGACAACCATATGAGA-1	GoodQuality
TGACAACCATCCTAGA-1	GoodQuality
TGACAACGTAGATTAG-1	GoodQuality
TGACAACTCAGTTCGA-1	LowQuality
TGACAACTCTACTCAT-1	LowQuality
TGACGGCAGCGCCTCA-1	GoodQuality
TGACGGCAGGCATGGT-1	LowQuality
TGACGGCAGGCTACGA-1	GoodQuality
TGACGGCAGGTGGGTT-1	GoodQuality
TGACGGCCACGTGAGA-1	GoodQuality
TGACGGCCAGCTATTG-1	GoodQuality
TGACGGCCATCTCGCT-1	GoodQuality
TGACGGCGTAACGCGA-1	GoodQuality
TGACGGCGTATTAGCC-1	LowQuality
TGACGGCGTGTGACCC-1	GoodQuality
TGACGGCGTTATCCGA-1	GoodQuality
TGACTAGAGCTGAACG-1	GoodQuality
TGACTAGAGGAGCGAG-1	GoodQuality
TGACTAGCAGACGTAG-1	GoodQuality
TGACTAGCATGAGCGA-1	GoodQuality
TGACTAGGTGTAACGG-1	GoodQuality
TGACTAGGTTATCGGT-1	LowQuality
TGACTAGTCAGTGCAT-1	GoodQuality
TGACTAGTCCTTTCGG-1	GoodQuality
TGACTTTAGAACTGTA-1	GoodQuality
TGACTTTAGCCTCGTG-1	GoodQuality
TGACTTTAGCGTTGCC-1	GoodQuality
TGACTTTAGCTAGTTC-1	GoodQuality
TGACTTTAGTGACATA-1	LowQuality
TGACTTTCACGACTCG-1	GoodQuality
TGACTTTCAGAGCCAA-1	GoodQuality
TGACTTTCAGGCTCAC-1	LowQuality
TGACTTTCAGTTCATG-1	LowQuality
TGACTTTCATGCAACT-1	GoodQuality
TGACTTTGTAAATGTG-1	GoodQuality
TGACTTTGTAGGGACT-1	GoodQuality
TGACTTTGTTCAACCA-1	GoodQuality
TGACTTTTCCATGCTC-1	LowQuality
TGACTTTTCTGTCTAT-1	LowQuality
TGAGAGGAGGACTGGT-1	LowQuality
TGAGAGGCAACTGCGC-1	GoodQuality
TGAGAGGCACTCGACG-1	GoodQuality
TGAGAGGCAGCTCCGA-1	GoodQuality
TGAGAGGCAGGAATCG-1	GoodQuality
TGAGAGGGTAGGCTGA-1	GoodQuality
TGAGAGGGTCTAACGT-1	GoodQuality
TGAGAGGTCAAGGTAA-1	LowQuality
TGAGCATAGGTAGCCA-1	GoodQuality
TGAGCATCAAGAAAGG-1	GoodQuality
TGAGCATCAAGCGAGT-1	GoodQuality
TGAGCATCACGTCAGC-1	GoodQuality
TGAGCATCAGCCAGAA-1	GoodQuality
TGAGCATGTAGCCTCG-1	GoodQuality
TGAGCATGTGCAGGTA-1	GoodQuality
TGAGCATTCCAAATGC-1	LowQuality
TGAGCATTCCTTAATC-1	GoodQuality
TGAGCATTCGAGGTAG-1	GoodQuality
TGAGCATTCGTTGCCT-1	GoodQuality
TGAGCATTCTGGAGCC-1	GoodQuality
TGAGCATTCTTTACGT-1	GoodQuality
TGAGCCGAGAGAACAG-1	LowQuality
TGAGCCGAGAGACGAA-1	GoodQuality
TGAGCCGAGATCCCAT-1	GoodQuality
TGAGCCGAGTACACCT-1	LowQuality
TGAGCCGAGTCGCCGT-1	GoodQuality
TGAGCCGCACGGTAGA-1	GoodQuality
TGAGCCGGTGAGGGTT-1	GoodQuality
TGAGCCGGTTAAAGAC-1	LowQuality
TGAGCCGGTTCGTTGA-1	LowQuality
TGAGCCGTCCAGTAGT-1	LowQuality
TGAGCCGTCCGTAGGC-1	GoodQuality
TGAGCCGTCGTAGGAG-1	GoodQuality
TGAGCCGTCTAACGGT-1	GoodQuality
TGAGCCGTCTCCCTGA-1	LowQuality
TGAGCCGTCTGCCCTA-1	GoodQuality
TGAGGGAAGGGTATCG-1	GoodQuality
TGAGGGAAGTAACCCT-1	GoodQuality
TGAGGGACATCGGAAG-1	GoodQuality
TGAGGGACATCGGACC-1	LowQuality
TGAGGGAGTAACGACG-1	LowQuality
TGAGGGAGTAGAGCTG-1	LowQuality
TGAGGGATCAAGGTAA-1	GoodQuality
TGAGGGATCTTACCGC-1	GoodQuality
TGATTTCAGAGCTGCA-1	GoodQuality
TGATTTCAGCTAGCCC-1	GoodQuality
TGATTTCCAAGCTGAG-1	GoodQuality
TGATTTCCACCCTATC-1	GoodQuality
TGATTTCCACGACTCG-1	GoodQuality
TGATTTCCAGACACTT-1	GoodQuality
TGATTTCCAGCTGCTG-1	GoodQuality
TGATTTCCAGCTGGCT-1	GoodQuality
TGATTTCCATACGCTA-1	LowQuality
TGATTTCCATTCTCAT-1	LowQuality
TGATTTCGTAGGCTGA-1	GoodQuality
TGATTTCGTCTTCTCG-1	GoodQuality
TGATTTCGTGCTTCTC-1	GoodQuality
TGATTTCGTGGCAAAC-1	GoodQuality
TGATTTCTCCAGTATG-1	LowQuality
TGATTTCTCCTGTAGA-1	GoodQuality
TGATTTCTCGAGAACG-1	GoodQuality
TGCACCTAGCGATGAC-1	GoodQuality
TGCACCTAGCGTTTAC-1	GoodQuality
TGCACCTAGGACATTA-1	GoodQuality
TGCACCTAGGCATGGT-1	GoodQuality
TGCACCTAGGGCTCTC-1	GoodQuality
TGCACCTCAACTTGAC-1	GoodQuality
TGCACCTCATCCAACA-1	GoodQuality
TGCACCTGTAGGGTAC-1	LowQuality
TGCACCTTCAACGGGA-1	GoodQuality
TGCACCTTCGTGTAGT-1	LowQuality
TGCACCTTCTTTAGTC-1	GoodQuality
TGCCAAAAGACTACAA-1	GoodQuality
TGCCAAAAGAGCCCAA-1	GoodQuality
TGCCAAAAGATCCCAT-1	LowQuality
TGCCAAAAGCCGATTT-1	GoodQuality
TGCCAAAAGCTAACAA-1	GoodQuality
TGCCAAAAGCTTCGCG-1	LowQuality
TGCCAAAAGTAGGCCA-1	GoodQuality
TGCCAAAAGTCTCCTC-1	GoodQuality
TGCCAAAGTAAATGTG-1	GoodQuality
TGCCAAAGTACATGTC-1	GoodQuality
TGCCAAAGTAGTACCT-1	GoodQuality
TGCCAAAGTCTCATCC-1	LowQuality
TGCCAAAGTGGAAAGA-1	LowQuality
TGCCAAAGTTAGTGGG-1	GoodQuality
TGCCAAAGTTTAGGAA-1	LowQuality
TGCCAAATCAAAGTAG-1	GoodQuality
TGCCAAATCAGCTGGC-1	LowQuality
TGCCAAATCCAACCAA-1	LowQuality
TGCCAAATCGAGCCCA-1	LowQuality
TGCCAAATCGGAAACG-1	GoodQuality
TGCCCATAGGGCACTA-1	GoodQuality
TGCCCATAGGTACTCT-1	GoodQuality
TGCCCATAGTCGTACT-1	GoodQuality
TGCCCATCAACCGCCA-1	GoodQuality
TGCCCATCATGCTAGT-1	GoodQuality
TGCCCATGTCCGCTGA-1	GoodQuality
TGCCCATGTGGTGTAG-1	GoodQuality
TGCCCATGTTGTGGCC-1	LowQuality
TGCCCATTCAACGAAA-1	GoodQuality
TGCCCATTCAATAAGG-1	GoodQuality
TGCCCATTCTGGTTCC-1	LowQuality
TGCCCATTCTTGTACT-1	GoodQuality
TGCCCTAAGATCGGGT-1	GoodQuality
TGCCCTAAGCTGGAAC-1	GoodQuality
TGCCCTAAGGTGCACA-1	GoodQuality
TGCCCTAAGTTAAGTG-1	LowQuality
TGCCCTACAATCTGCA-1	GoodQuality
TGCCCTACATATGAGA-1	LowQuality
TGCCCTACATTACCTT-1	GoodQuality
TGCCCTAGTGCACGAA-1	GoodQuality
TGCCCTAGTGCTCTTC-1	GoodQuality
TGCCCTAGTTAGAACA-1	GoodQuality
TGCCCTATCCTTTACA-1	LowQuality
TGCCCTATCTGCTTGC-1	LowQuality
TGCGCAGAGCGTGAGT-1	LowQuality
TGCGCAGAGGCACATG-1	LowQuality
TGCGCAGAGTAAGTAC-1	GoodQuality
TGCGCAGAGTCGATAA-1	GoodQuality
TGCGCAGCAAGCCTAT-1	LowQuality
TGCGCAGCACCAGTTA-1	LowQuality
TGCGCAGCACGGCGTT-1	GoodQuality
TGCGCAGGTCCCTTGT-1	GoodQuality
TGCGCAGGTCTAGTCA-1	LowQuality
TGCGCAGGTGTAATGA-1	GoodQuality
TGCGCAGTCAAACCAC-1	GoodQuality
TGCGCAGTCAAAGACA-1	LowQuality
TGCGCAGTCAGCAACT-1	GoodQuality
TGCGGGTAGGGAACGG-1	GoodQuality
TGCGGGTCACCCTATC-1	LowQuality
TGCGGGTCACTTAACG-1	LowQuality
TGCGGGTCACTTAAGC-1	LowQuality
TGCGGGTCAGGAATGC-1	GoodQuality
TGCGGGTCATCGATTG-1	LowQuality
TGCGGGTCATTTCACT-1	GoodQuality
TGCGGGTGTCGCGGTT-1	GoodQuality
TGCGGGTTCATTGCCC-1	GoodQuality
TGCGGGTTCCTTTACA-1	GoodQuality
TGCGGGTTCTATCCTA-1	GoodQuality
TGCGTGGAGAGCAATT-1	LowQuality
TGCGTGGAGAGTACCG-1	GoodQuality
TGCGTGGAGATCCCGC-1	GoodQuality
TGCGTGGAGGCTCATT-1	GoodQuality
TGCGTGGAGTGCTGCC-1	GoodQuality
TGCGTGGCACAACGCC-1	LowQuality
TGCGTGGCACAACTGT-1	LowQuality
TGCGTGGCAGACTCGC-1	GoodQuality
TGCGTGGGTAGCGCAA-1	GoodQuality
TGCGTGGGTAGGCTGA-1	GoodQuality
TGCGTGGTCCGCGGTA-1	LowQuality
TGCGTGGTCCTTCAAT-1	GoodQuality
TGCTACCAGATCGGGT-1	GoodQuality
TGCTACCAGCTCCTTC-1	GoodQuality
TGCTACCAGGCAATTA-1	GoodQuality
TGCTACCAGTCTCAAC-1	LowQuality
TGCTACCCAAAGGTGC-1	GoodQuality
TGCTACCCACAAGTAA-1	GoodQuality
TGCTACCCACTGTCGG-1	GoodQuality
TGCTACCCAGTATGCT-1	GoodQuality
TGCTACCCATGCTGGC-1	GoodQuality
TGCTACCGTTATCCGA-1	GoodQuality
TGCTACCTCTCTGTCG-1	LowQuality
TGCTGCTCAAGTCATC-1	GoodQuality
TGCTGCTCACAGTCGC-1	LowQuality
TGCTGCTGTCAAACTC-1	GoodQuality
TGCTGCTGTCATGCAT-1	GoodQuality
TGCTGCTGTTAGGGTG-1	LowQuality
TGCTGCTTCAGCATGT-1	GoodQuality
TGCTGCTTCAGGTAAA-1	GoodQuality
TGCTGCTTCCAGAGGA-1	GoodQuality
TGCTGCTTCGCCCTTA-1	GoodQuality
TGGACGCAGAAGCCCA-1	GoodQuality
TGGACGCAGATAGCAT-1	GoodQuality
TGGACGCAGGGTTCCC-1	LowQuality
TGGACGCAGGGTTTCT-1	GoodQuality
TGGACGCAGTGACTCT-1	GoodQuality
TGGACGCAGTGCAAGC-1	GoodQuality
TGGACGCCACTGTCGG-1	GoodQuality
TGGACGCCAGCCAATT-1	GoodQuality
TGGACGCCAGTCGATT-1	GoodQuality
TGGACGCCATCGATTG-1	LowQuality
TGGACGCGTGGCTCCA-1	LowQuality
TGGACGCTCATCACCC-1	LowQuality
TGGACGCTCTAGAGTC-1	GoodQuality
TGGACGCTCTCGGACG-1	GoodQuality
TGGACGCTCTGCTGTC-1	GoodQuality
TGGCCAGAGCTAGTCT-1	GoodQuality
TGGCCAGAGGGTCTCC-1	GoodQuality
TGGCCAGAGTGATCGG-1	GoodQuality
TGGCCAGGTCAATGTC-1	LowQuality
TGGCCAGGTCTAGGTT-1	GoodQuality
TGGCCAGTCAGCTCTC-1	LowQuality
TGGCCAGTCCGAAGAG-1	GoodQuality
TGGCCAGTCGAATGCT-1	LowQuality
TGGCCAGTCGCCGTGA-1	GoodQuality
TGGCGCAAGACCTAGG-1	GoodQuality
TGGCGCAAGGATGCGT-1	GoodQuality
TGGCGCACAAACGCGA-1	GoodQuality
TGGCGCAGTTAGGGTG-1	LowQuality
TGGCGCATCAGCAACT-1	GoodQuality
TGGCGCATCCCACTTG-1	GoodQuality
TGGCGCATCGAGAACG-1	GoodQuality
TGGCGCATCGTAGGAG-1	LowQuality
TGGCGCATCTCTAAGG-1	GoodQuality
TGGCGCATCTTGCAAG-1	GoodQuality
TGGCTGGAGCTAGTGG-1	GoodQuality
TGGCTGGAGCTTTGGT-1	LowQuality
TGGCTGGCAATAAGCA-1	GoodQuality
TGGCTGGCACCTATCC-1	LowQuality
TGGCTGGCACTGTGTA-1	LowQuality
TGGCTGGGTACCGCTG-1	GoodQuality
TGGCTGGGTCATATCG-1	GoodQuality
TGGCTGGGTGCCTGTG-1	LowQuality
TGGCTGGGTGTTTGGT-1	GoodQuality
TGGCTGGGTTAAGTAG-1	GoodQuality
TGGCTGGTCCGCATAA-1	LowQuality
TGGCTGGTCGGCGCAT-1	GoodQuality
TGGCTGGTCTTCTGGC-1	LowQuality
TGGGAAGAGATCCGAG-1	GoodQuality
TGGGAAGAGGGATGGG-1	GoodQuality
TGGGAAGAGTACGCCC-1	GoodQuality
TGGGAAGCAAAGGCGT-1	GoodQuality
TGGGAAGCACGGACAA-1	GoodQuality
TGGGAAGCAGGTCCAC-1	LowQuality
TGGGAAGCAGTTTACG-1	LowQuality
TGGGAAGCATGTCGAT-1	LowQuality
TGGGAAGGTACCGCTG-1	GoodQuality
TGGGAAGTCATGCTCC-1	LowQuality
TGGGAAGTCCTAGTGA-1	GoodQuality
TGGGAAGTCGTTTGCC-1	GoodQuality
TGGGCGTAGATCACGG-1	GoodQuality
TGGGCGTAGCCGGTAA-1	LowQuality
TGGGCGTAGGAGCGAG-1	GoodQuality
TGGGCGTAGTTGCAGG-1	GoodQuality
TGGGCGTCAACCGCCA-1	GoodQuality
TGGGCGTCAATGACCT-1	GoodQuality
TGGGCGTCATGCTGGC-1	GoodQuality
TGGGCGTGTACCGCTG-1	GoodQuality
TGGGCGTGTCTAACGT-1	GoodQuality
TGGGCGTGTCTCCATC-1	LowQuality
TGGGCGTGTGTAACGG-1	GoodQuality
TGGGCGTGTTAGATGA-1	GoodQuality
TGGGCGTGTTCACGGC-1	GoodQuality
TGGGCGTTCTCCCTGA-1	GoodQuality
TGGTTAGAGAACAATC-1	GoodQuality
TGGTTAGCAGTCTTCC-1	GoodQuality
TGGTTAGCATGGAATA-1	GoodQuality
TGGTTAGGTACAGTTC-1	GoodQuality
TGGTTAGGTATAGTAG-1	LowQuality
TGGTTAGTCACCGTAA-1	GoodQuality
TGGTTAGTCGAGCCCA-1	LowQuality
TGGTTAGTCTGCTGTC-1	GoodQuality
TGGTTCCAGGCTCAGA-1	GoodQuality
TGGTTCCAGGGTATCG-1	GoodQuality
TGGTTCCAGTTAGGTA-1	LowQuality
TGGTTCCCACACATGT-1	GoodQuality
TGGTTCCCATCAGTCA-1	GoodQuality
TGGTTCCCATTAGGCT-1	GoodQuality
TGGTTCCGTAAGAGGA-1	LowQuality
TGGTTCCGTCCGAATT-1	LowQuality
TGGTTCCGTCGAACAG-1	GoodQuality
TGGTTCCGTGTTGGGA-1	GoodQuality
TGGTTCCGTTGACGTT-1	LowQuality
TGGTTCCGTTGAGGTG-1	GoodQuality
TGGTTCCTCAGCTCTC-1	LowQuality
TGTATTCAGTAGTGCG-1	GoodQuality
TGTATTCCAAAGGCGT-1	LowQuality
TGTATTCGTCAAACTC-1	GoodQuality
TGTATTCGTCGATTGT-1	GoodQuality
TGTATTCGTCTAGCGC-1	GoodQuality
TGTATTCGTGCGCTTG-1	LowQuality
TGTATTCGTGGTCCGT-1	GoodQuality
TGTATTCTCGCGATCG-1	GoodQuality
TGTATTCTCGTTTATC-1	GoodQuality
TGTCCCAAGAGGTTAT-1	GoodQuality
TGTCCCACAACTGGCC-1	GoodQuality
TGTCCCACAAGCTGAG-1	GoodQuality
TGTCCCACACACCGCA-1	GoodQuality
TGTCCCACAGTCACTA-1	GoodQuality
TGTCCCACATATACGC-1	GoodQuality
TGTCCCACATGAAGTA-1	GoodQuality
TGTCCCAGTCAGCTAT-1	GoodQuality
TGTCCCAGTCGTTGTA-1	GoodQuality
TGTCCCATCCTTTCGG-1	GoodQuality
TGTGGTAAGACGCACA-1	LowQuality
TGTGGTAAGAGCTGCA-1	LowQuality
TGTGGTAAGATATGGT-1	LowQuality
TGTGGTAAGCACCGCT-1	LowQuality
TGTGGTAAGCCTATGT-1	GoodQuality
TGTGGTAAGCGATGAC-1	GoodQuality
TGTGGTACAAACGTGG-1	GoodQuality
TGTGGTACACGTAAGG-1	GoodQuality
TGTGGTACAGCTGTTA-1	GoodQuality
TGTGGTAGTGACTACT-1	GoodQuality
TGTGGTATCAGTCCCT-1	GoodQuality
TGTGGTATCTACGAGT-1	GoodQuality
TGTGTTTAGACAAAGG-1	GoodQuality
TGTGTTTAGAGGGCTT-1	GoodQuality
TGTGTTTAGATGCCTT-1	LowQuality
TGTGTTTAGGCCATAG-1	GoodQuality
TGTGTTTAGTGAAGAG-1	GoodQuality
TGTGTTTCAAGAAGAG-1	GoodQuality
TGTGTTTCAATCCGAT-1	LowQuality
TGTGTTTCACAACGCC-1	GoodQuality
TGTGTTTCACACCGCA-1	LowQuality
TGTGTTTCATAGACTC-1	GoodQuality
TGTGTTTCATTCCTCG-1	GoodQuality
TGTGTTTGTACCGAGA-1	GoodQuality
TGTGTTTTCACTCTTA-1	LowQuality
TGTGTTTTCGTCGTTC-1	GoodQuality
TGTGTTTTCTTTACGT-1	LowQuality
TGTGTTTTCTTTAGTC-1	GoodQuality
TGTTCCGAGGCTAGAC-1	GoodQuality
TGTTCCGAGTGGAGAA-1	GoodQuality
TGTTCCGCACCCAGTG-1	GoodQuality
TGTTCCGCACGAAGCA-1	LowQuality
TGTTCCGCAGCGTAAG-1	GoodQuality
TGTTCCGGTCAGGACA-1	GoodQuality
TGTTCCGGTGAGGGAG-1	LowQuality
TGTTCCGTCCAAACAC-1	GoodQuality
TGTTCCGTCCTTGGTC-1	LowQuality
TGTTCCGTCGAGAGCA-1	LowQuality
TGTTCCGTCTCCAACC-1	GoodQuality
TTAACTCAGAAAGTGG-1	GoodQuality
TTAACTCGTCTGATTG-1	GoodQuality
TTAACTCGTGAGTATA-1	GoodQuality
TTAACTCGTTCCAACA-1	GoodQuality
TTAACTCGTTTGTTGG-1	LowQuality
TTAACTCTCACCGGGT-1	GoodQuality
TTAACTCTCACTGGGC-1	GoodQuality
TTAACTCTCTAGAGTC-1	GoodQuality
TTAACTCTCTCTTATG-1	LowQuality
TTAGGACAGGTTACCT-1	GoodQuality
TTAGGACCAAGCTGTT-1	GoodQuality
TTAGGACCACGAAGCA-1	GoodQuality
TTAGGACGTACCAGTT-1	GoodQuality
TTAGGACGTAGCTAAA-1	GoodQuality
TTAGGACGTAGGCTGA-1	GoodQuality
TTAGGACTCGGAATCT-1	LowQuality
TTAGGACTCTTCGAGA-1	LowQuality
TTAGGCAAGAACAATC-1	GoodQuality
TTAGGCAAGAGGGCTT-1	GoodQuality
TTAGGCAAGCCACCTG-1	GoodQuality
TTAGGCAAGGTGATTA-1	GoodQuality
TTAGGCACAACTTGAC-1	LowQuality
TTAGGCACAAGTAGTA-1	GoodQuality
TTAGGCACACCAGATT-1	LowQuality
TTAGGCACAGCTGTGC-1	GoodQuality
TTAGGCAGTATAAACG-1	GoodQuality
TTAGGCATCACGCATA-1	GoodQuality
TTAGGCATCATCTGTT-1	GoodQuality
TTAGGCATCTTCATGT-1	GoodQuality
TTAGTTCAGACAGACC-1	GoodQuality
TTAGTTCAGATATACG-1	GoodQuality
TTAGTTCAGCTATGCT-1	GoodQuality
TTAGTTCAGTGCCAGA-1	GoodQuality
TTAGTTCCAACTGCGC-1	LowQuality
TTAGTTCCAGACGCAA-1	LowQuality
TTAGTTCCAGGGTACA-1	GoodQuality
TTAGTTCCAGGTGGAT-1	GoodQuality
TTAGTTCCATCTCCCA-1	GoodQuality
TTAGTTCGTCCGCTGA-1	GoodQuality
TTAGTTCGTTCGCGAC-1	GoodQuality
TTAGTTCGTTGGTTTG-1	GoodQuality
TTAGTTCTCGTCACGG-1	GoodQuality
TTAGTTCTCTGGGCCA-1	GoodQuality
TTATGCTAGAAGGACA-1	GoodQuality
TTATGCTAGTCAATAG-1	LowQuality
TTATGCTAGTCTCAAC-1	LowQuality
TTATGCTAGTGTACTC-1	GoodQuality
TTATGCTAGTTTGCGT-1	LowQuality
TTATGCTCACCAGCAC-1	GoodQuality
TTATGCTCACGTCAGC-1	LowQuality
TTATGCTCACTATCTT-1	GoodQuality
TTATGCTCATAGTAAG-1	LowQuality
TTATGCTGTGCACGAA-1	GoodQuality
TTATGCTGTGTAACGG-1	GoodQuality
TTATGCTGTTCAGTAC-1	GoodQuality
TTATGCTGTTGATTGC-1	LowQuality
TTATGCTGTTTACTCT-1	LowQuality
TTATGCTTCACAAACC-1	GoodQuality
TTATGCTTCCATTCTA-1	LowQuality
TTCCCAGAGAACAATC-1	GoodQuality
TTCCCAGAGACTTGAA-1	GoodQuality
TTCCCAGAGAGTACAT-1	GoodQuality
TTCCCAGAGAGTACCG-1	GoodQuality
TTCCCAGAGATGGCGT-1	LowQuality
TTCCCAGAGCTGTTCA-1	GoodQuality
TTCCCAGAGGCATGGT-1	LowQuality
TTCCCAGAGGTAGCCA-1	LowQuality
TTCCCAGCACAAGACG-1	GoodQuality
TTCCCAGCACTGTGTA-1	GoodQuality
TTCCCAGCATCGGGTC-1	GoodQuality
TTCCCAGTCAGCATGT-1	LowQuality
TTCGAAGAGACTAGGC-1	GoodQuality
TTCGAAGAGCGATAGC-1	GoodQuality
TTCGAAGAGTTTGCGT-1	GoodQuality
TTCGAAGCATCGATTG-1	GoodQuality
TTCGAAGCATCTATGG-1	GoodQuality
TTCGAAGGTATCTGCA-1	GoodQuality
TTCGAAGGTTGCTCCT-1	LowQuality
TTCGAAGTCAAGATCC-1	GoodQuality
TTCGAAGTCCACTCCA-1	GoodQuality
TTCGAAGTCCTGCAGG-1	LowQuality
TTCGAAGTCGCACTCT-1	GoodQuality
TTCGGTCCAAGGTTCT-1	GoodQuality
TTCGGTCCACGAAAGC-1	LowQuality
TTCGGTCCAGTGACAG-1	GoodQuality
TTCGGTCCATTCTCAT-1	LowQuality
TTCGGTCCATTGGGCC-1	LowQuality
TTCGGTCGTAAGGGCT-1	GoodQuality
TTCGGTCGTAAGTTCC-1	GoodQuality
TTCGGTCGTCTAGAGG-1	GoodQuality
TTCGGTCGTGTAACGG-1	GoodQuality
TTCGGTCTCGGCATCG-1	GoodQuality
TTCTACAAGATCACGG-1	GoodQuality
TTCTACAAGCTGAAAT-1	GoodQuality
TTCTACACACGGCTAC-1	GoodQuality
TTCTACACAGCGATCC-1	GoodQuality
TTCTACACAGGCAGTA-1	GoodQuality
TTCTACACATACGCCG-1	GoodQuality
TTCTACACATAGTAAG-1	GoodQuality
TTCTACAGTTAAGTAG-1	LowQuality
TTCTACATCCCTTGTG-1	GoodQuality
TTCTACATCGGCTTGG-1	LowQuality
TTCTACATCGGTTCGG-1	LowQuality
TTCTACATCTCTGCTG-1	GoodQuality
TTCTCAAAGATAGGAG-1	GoodQuality
TTCTCAAAGATCTGCT-1	LowQuality
TTCTCAAAGCAGGCTA-1	GoodQuality
TTCTCAAAGGGCATGT-1	LowQuality
TTCTCAACAAACTGTC-1	LowQuality
TTCTCAACAAGAGTCG-1	LowQuality
TTCTCAACAAGTACCT-1	GoodQuality
TTCTCAACAGGCTCAC-1	GoodQuality
TTCTCAACATCTGGTA-1	GoodQuality
TTCTCAACATGCCACG-1	GoodQuality
TTCTCAAGTACAGCAG-1	GoodQuality
TTCTCAAGTATATGAG-1	GoodQuality
TTCTCAAGTTGGTTTG-1	GoodQuality
TTCTCAATCCATGCTC-1	GoodQuality
TTCTCAATCCTCAATT-1	GoodQuality
TTCTCAATCTTGTACT-1	GoodQuality
TTCTCCTAGATAGTCA-1	LowQuality
TTCTCCTAGTGCCAGA-1	GoodQuality
TTCTCCTAGTGGGTTG-1	GoodQuality
TTCTCCTAGTTTGCGT-1	GoodQuality
TTCTCCTCAACGATCT-1	LowQuality
TTCTCCTGTAGCCTAT-1	LowQuality
TTCTCCTGTGGCCCTA-1	LowQuality
TTCTCCTGTGGTCCGT-1	LowQuality
TTCTCCTTCAAGAAGT-1	GoodQuality
TTCTCCTTCAGCAACT-1	GoodQuality
TTCTCCTTCCTAGTGA-1	GoodQuality
TTCTCCTTCTAACCGA-1	GoodQuality
TTCTCCTTCTTGCATT-1	LowQuality
TTCTTAGAGATAGTCA-1	GoodQuality
TTCTTAGAGCGTCTAT-1	LowQuality
TTCTTAGAGTGGGCTA-1	GoodQuality
TTCTTAGCAACACGCC-1	LowQuality
TTCTTAGCAGACAAAT-1	LowQuality
TTCTTAGCAGCTATTG-1	LowQuality
TTCTTAGCAGGCTGAA-1	GoodQuality
TTCTTAGGTATGAAAC-1	GoodQuality
TTCTTAGGTATTCTCT-1	GoodQuality
TTCTTAGTCACATACG-1	GoodQuality
TTCTTAGTCCTCCTAG-1	GoodQuality
TTCTTAGTCGGTGTCG-1	LowQuality
TTCTTAGTCGTGGACC-1	GoodQuality
TTCTTAGTCGTTTATC-1	GoodQuality
TTCTTAGTCTCAAACG-1	GoodQuality
TTCTTAGTCTTTCCTC-1	GoodQuality
TTGAACGAGTACATGA-1	GoodQuality
TTGAACGCAAACGTGG-1	LowQuality
TTGAACGCAGTAGAGC-1	LowQuality
TTGAACGGTAAATACG-1	GoodQuality
TTGAACGGTACCAGTT-1	GoodQuality
TTGAACGGTACTTGAC-1	LowQuality
TTGAACGGTCGCCATG-1	GoodQuality
TTGAACGGTCTCAACA-1	GoodQuality
TTGAACGGTGACTACT-1	GoodQuality
TTGAACGGTGATAAAC-1	GoodQuality
TTGAACGGTGCTGTAT-1	GoodQuality
TTGAACGGTTGGGACA-1	GoodQuality
TTGAACGTCCTTGCCA-1	GoodQuality
TTGAACGTCGCTTAGA-1	LowQuality
TTGACTTAGGCTAGCA-1	LowQuality
TTGACTTAGTCCTCCT-1	GoodQuality
TTGACTTAGTGAATTG-1	GoodQuality
TTGACTTCAAACCCAT-1	GoodQuality
TTGACTTCAAGGACAC-1	LowQuality
TTGACTTCACGGCTAC-1	GoodQuality
TTGACTTCAGATCGGA-1	GoodQuality
TTGACTTGTAGGCTGA-1	GoodQuality
TTGACTTGTCCAACTA-1	GoodQuality
TTGACTTGTCCTAGCG-1	GoodQuality
TTGACTTGTCGCGGTT-1	GoodQuality
TTGACTTGTGCTCTTC-1	LowQuality
TTGACTTGTTAGATGA-1	LowQuality
TTGACTTGTTCAGCGC-1	LowQuality
TTGACTTGTTCCATGA-1	GoodQuality
TTGACTTTCAAACCAC-1	GoodQuality
TTGACTTTCAACGGCC-1	GoodQuality
TTGACTTTCATGCAAC-1	LowQuality
TTGACTTTCGATAGAA-1	LowQuality
TTGACTTTCTACGAGT-1	LowQuality
TTGACTTTCTCGGACG-1	LowQuality
TTGACTTTCTTGAGGT-1	GoodQuality
TTGCCGTAGCGCCTTG-1	LowQuality
TTGCCGTAGGCCCTCA-1	GoodQuality
TTGCCGTAGGGAAACA-1	GoodQuality
TTGCCGTAGTGTCCAT-1	LowQuality
TTGCCGTCAGGTGCCT-1	GoodQuality
TTGCCGTCAGTTAACC-1	GoodQuality
TTGCCGTCATCTCGCT-1	GoodQuality
TTGCCGTGTAGTGAAT-1	LowQuality
TTGCCGTGTCAAGCGA-1	GoodQuality
TTGCCGTGTCCAGTTA-1	GoodQuality
TTGCCGTGTCTTTCAT-1	GoodQuality
TTGCCGTGTTACGCGC-1	GoodQuality
TTGCCGTTCAACGAAA-1	GoodQuality
TTGCCGTTCACAGTAC-1	GoodQuality
TTGCCGTTCAGAGCTT-1	LowQuality
TTGCCGTTCCACGAAT-1	GoodQuality
TTGCCGTTCCTTTACA-1	GoodQuality
TTGCCGTTCGACAGCC-1	GoodQuality
TTGCCGTTCTCAAGTG-1	LowQuality
TTGCCGTTCTCGATGA-1	GoodQuality
TTGCGTCAGAAGGTTT-1	GoodQuality
TTGCGTCAGAATTGTG-1	GoodQuality
TTGCGTCAGGTGGGTT-1	GoodQuality
TTGCGTCCAAGGACTG-1	LowQuality
TTGCGTCCACGAAGCA-1	GoodQuality
TTGCGTCCAGATCCAT-1	GoodQuality
TTGCGTCCAGCGATCC-1	LowQuality
TTGCGTCCAGCTGTGC-1	GoodQuality
TTGCGTCCATCACGAT-1	GoodQuality
TTGCGTCGTAGTAGTA-1	LowQuality
TTGCGTCGTATTACCG-1	LowQuality
TTGCGTCGTTGCGCAC-1	GoodQuality
TTGCGTCTCAGCAACT-1	GoodQuality
TTGCGTCTCTTGCCGT-1	GoodQuality
TTGGAACAGAAGCCCA-1	GoodQuality
TTGGAACAGTCATGCT-1	LowQuality
TTGGAACAGTGTACCT-1	LowQuality
TTGGAACCAGTATGCT-1	LowQuality
TTGGAACGTACTCAAC-1	GoodQuality
TTGGAACGTCATGCCG-1	GoodQuality
TTGGAACGTTGTACAC-1	LowQuality
TTGGAACTCCACGTTC-1	GoodQuality
TTGGAACTCCCTTGTG-1	GoodQuality
TTGGAACTCGATAGAA-1	GoodQuality
TTGGCAAAGATGTTAG-1	GoodQuality
TTGGCAAAGCCCAATT-1	GoodQuality
TTGGCAAAGGCCCTCA-1	GoodQuality
TTGGCAACAATGAATG-1	GoodQuality
TTGGCAACATCTGGTA-1	GoodQuality
TTGGCAAGTAAAGGAG-1	LowQuality
TTGGCAAGTACTCTCC-1	GoodQuality
TTGGCAAGTAGCTTGT-1	GoodQuality
TTGGCAAGTGGAAAGA-1	GoodQuality
TTGGCAAGTTCTGAAC-1	GoodQuality
TTGGCAATCAGCCTAA-1	GoodQuality
TTGGCAATCATGGTCA-1	LowQuality
TTGGCAATCGATAGAA-1	GoodQuality
TTGGCAATCGCAAGCC-1	GoodQuality
TTGGCAATCGGATGTT-1	GoodQuality
TTGGCAATCTTCATGT-1	LowQuality
TTGTAGGAGAAACGAG-1	GoodQuality
TTGTAGGAGAAACGCC-1	GoodQuality
TTGTAGGAGATGAGAG-1	GoodQuality
TTGTAGGAGCCCAACC-1	GoodQuality
TTGTAGGCAGGACCCT-1	GoodQuality
TTGTAGGGTATATCCG-1	GoodQuality
TTGTAGGGTGCAACGA-1	GoodQuality
TTGTAGGGTTACGACT-1	LowQuality
TTGTAGGTCAGCTCTC-1	GoodQuality
TTGTAGGTCAGGTTCA-1	LowQuality
TTGTAGGTCCTTTCGG-1	GoodQuality
TTTACTGAGAAACCGC-1	GoodQuality
TTTACTGAGCCATCGC-1	LowQuality
TTTACTGAGCGTAGTG-1	GoodQuality
TTTACTGAGCTAGTGG-1	LowQuality
TTTACTGAGTCTCAAC-1	GoodQuality
TTTACTGAGTGAATTG-1	GoodQuality
TTTACTGAGTTTCCTT-1	GoodQuality
TTTACTGCAAGGGTCA-1	LowQuality
TTTACTGCACCATGTA-1	LowQuality
TTTACTGCAGATGGGT-1	GoodQuality
TTTACTGCAGCGTTCG-1	GoodQuality
TTTACTGCATGCTGGC-1	LowQuality
TTTACTGGTCATATGC-1	LowQuality
TTTACTGGTTACCGAT-1	LowQuality
TTTACTGTCAACACTG-1	LowQuality
TTTACTGTCAACGGGA-1	GoodQuality
TTTACTGTCACCCTCA-1	LowQuality
TTTACTGTCCTGCAGG-1	LowQuality
TTTACTGTCTTCCTTC-1	GoodQuality
TTTATGCAGATGTTAG-1	GoodQuality
TTTATGCAGATTACCC-1	GoodQuality
TTTATGCAGCCTATGT-1	GoodQuality
TTTATGCAGCGATTCT-1	GoodQuality
TTTATGCAGTAGCGGT-1	GoodQuality
TTTATGCAGTTAGGTA-1	GoodQuality
TTTATGCCAAAGCGGT-1	LowQuality
TTTATGCCAATCGGTT-1	GoodQuality
TTTATGCCAATCTGCA-1	GoodQuality
TTTATGCCAATGGATA-1	GoodQuality
TTTATGCCACATCCGG-1	GoodQuality
TTTATGCTCATGTCCC-1	GoodQuality
TTTATGCTCCCGGATG-1	GoodQuality
TTTATGCTCCTCCTAG-1	GoodQuality
TTTATGCTCGGCGGTT-1	GoodQuality
TTTATGCTCGTTTATC-1	GoodQuality
TTTATGCTCTTGTATC-1	GoodQuality
TTTCCTCAGCAATATG-1	LowQuality
TTTCCTCAGGGCTCTC-1	GoodQuality
TTTCCTCCATTGGGCC-1	GoodQuality
TTTCCTCGTATCGCAT-1	GoodQuality
TTTCCTCGTTGAACTC-1	GoodQuality
TTTCCTCTCCTGCAGG-1	GoodQuality
TTTGCGCAGATGCGAC-1	GoodQuality
TTTGCGCAGGGCTCTC-1	LowQuality
TTTGCGCAGGGTGTGT-1	LowQuality
TTTGCGCCAAGGACAC-1	GoodQuality
TTTGCGCCAGGATTGG-1	GoodQuality
TTTGCGCGTAGCGTAG-1	GoodQuality
TTTGCGCGTCGAGATG-1	LowQuality
TTTGCGCGTCGATTGT-1	LowQuality
TTTGCGCGTGTGTGCC-1	LowQuality
TTTGCGCGTTACGTCA-1	LowQuality
TTTGCGCTCAAGGTAA-1	GoodQuality
TTTGCGCTCATCTGTT-1	GoodQuality
TTTGCGCTCGAATCCA-1	LowQuality
TTTGCGCTCTGTTTGT-1	LowQuality
TTTGGTTAGAGGTTGC-1	LowQuality
TTTGGTTAGCAGATCG-1	LowQuality
TTTGGTTAGCTAGGCA-1	GoodQuality
TTTGGTTAGTACCGGA-1	GoodQuality
TTTGGTTCAACGATCT-1	GoodQuality
TTTGGTTCACCACGTG-1	GoodQuality
TTTGGTTCACTGAAGG-1	GoodQuality
TTTGGTTCAGACGCCT-1	GoodQuality
TTTGGTTCAGACGCTC-1	GoodQuality
TTTGGTTGTAAGGGAA-1	LowQuality
TTTGGTTTCGAACTGT-1	GoodQuality
TTTGGTTTCGTACGGC-1	LowQuality
TTTGGTTTCGTTGACA-1	LowQuality
TTTGTCAAGAAGCCCA-1	GoodQuality
TTTGTCAAGCAAATCA-1	GoodQuality
TTTGTCACATCGGGTC-1	GoodQuality
TTTGTCAGTAGCTCCG-1	GoodQuality
TTTGTCAGTCTAGCCG-1	GoodQuality
TTTGTCAGTCTGATCA-1	GoodQuality
TTTGTCAGTGCTTCTC-1	GoodQuality
TTTGTCAGTGGTGTAG-1	LowQuality
TTTGTCAGTTACGTCA-1	GoodQuality
TTTGTCAGTTCGGGCT-1	LowQuality
TTTGTCAGTTTGTTGG-1	LowQuality
TTTGTCATCACCCTCA-1	LowQuality
TTTGTCATCGAGAGCA-1	GoodQuality
TTTGTCATCGCTAGCG-1	GoodQuality
TTTGTCATCTACTATC-1	GoodQuality
TTTGTCATCTCATTCA-1	GoodQuality
TTTGTCATCTTCATGT-1	LowQuality
