barcode	dropkick_label_03
AAACCTGCACGACGAA-1	GoodQuality
AAACCTGCAGGCGATA-1	GoodQuality
AAACCTGCATTGGTAC-1	GoodQuality
AAACCTGGTCACAAGG-1	GoodQuality
AAACCTGGTCCGCTGA-1	GoodQuality
AAACCTGGTGCGGTAA-1	GoodQuality
AAACCTGGTGGTGTAG-1	LowQuality
AAACCTGTCAAGATCC-1	GoodQuality
AAACCTGTCGTCGTTC-1	LowQuality
AAACGGGCACCAGATT-1	GoodQuality
AAACGGGCACGCATCG-1	GoodQuality
AAACGGGCACTAAGTC-1	GoodQuality
AAACGGGCATGAGCGA-1	GoodQuality
AAACGGGTCAGCTCGG-1	GoodQuality
AAACGGGTCGGATGTT-1	GoodQuality
AAACGGGTCTTTAGTC-1	GoodQuality
AAAGATGAGACTAAGT-1	GoodQuality
AAAGATGCAATCTACG-1	GoodQuality
AAAGATGCACATTCGA-1	GoodQuality
AAAGATGCAGTTCATG-1	LowQuality
AAAGATGCATTGGTAC-1	LowQuality
AAAGATGGTAGCGCAA-1	LowQuality
AAAGATGGTCCGTGAC-1	GoodQuality
AAAGATGTCTATGTGG-1	LowQuality
AAAGATGTCTTGAGAC-1	GoodQuality
AAAGCAAAGGTCGGAT-1	LowQuality
AAAGCAACAAAGAATC-1	GoodQuality
AAAGCAACACAACGTT-1	GoodQuality
AAAGCAACACTTCTGC-1	LowQuality
AAAGCAACAGACAAGC-1	LowQuality
AAAGCAACAGACTCGC-1	GoodQuality
AAAGCAAGTCTTGTCC-1	GoodQuality
AAAGCAAGTTAGTGGG-1	GoodQuality
AAAGCAATCAGCATGT-1	LowQuality
AAAGCAATCGGGAGTA-1	GoodQuality
AAAGTAGAGCAGCCTC-1	LowQuality
AAAGTAGAGTCATGCT-1	GoodQuality
AAAGTAGCAAAGGCGT-1	GoodQuality
AAAGTAGCAGCATACT-1	GoodQuality
AAAGTAGCAGCTGTAT-1	LowQuality
AAAGTAGGTAAGAGGA-1	GoodQuality
AAAGTAGGTACAGCAG-1	GoodQuality
AAAGTAGGTAGTGAAT-1	GoodQuality
AAAGTAGGTCTCTCGT-1	LowQuality
AAAGTAGTCTGATACG-1	LowQuality
AAATGCCAGAGTCGGT-1	GoodQuality
AAATGCCAGCGTGAAC-1	GoodQuality
AAATGCCAGTACGATA-1	LowQuality
AAATGCCAGTGAATTG-1	LowQuality
AAATGCCGTCCGAAGA-1	LowQuality
AAATGCCGTCTCGTTC-1	LowQuality
AAATGCCGTCTGCAAT-1	LowQuality
AAATGCCGTTCAGGCC-1	GoodQuality
AAATGCCGTTTAAGCC-1	GoodQuality
AAATGCCTCACAGTAC-1	GoodQuality
AAATGCCTCACGAAGG-1	GoodQuality
AAATGCCTCTGTTGAG-1	GoodQuality
AACACGTAGAGGTTAT-1	GoodQuality
AACACGTAGTGTGAAT-1	LowQuality
AACACGTCAAAGCAAT-1	GoodQuality
AACACGTCAGACAAAT-1	GoodQuality
AACACGTCAGGAATCG-1	GoodQuality
AACACGTCAGTCAGCC-1	LowQuality
AACACGTGTAGCTCCG-1	LowQuality
AACACGTTCAGTTGAC-1	GoodQuality
AACCATGAGAGACTAT-1	GoodQuality
AACCATGAGAGTTGGC-1	GoodQuality
AACCATGAGATATGGT-1	LowQuality
AACCATGCATCGGAAG-1	GoodQuality
AACCATGGTCAATACC-1	LowQuality
AACCATGGTCCATGAT-1	LowQuality
AACCATGGTGGCAAAC-1	GoodQuality
AACCATGTCAATCTCT-1	GoodQuality
AACCATGTCCTATGTT-1	GoodQuality
AACCATGTCCTTTACA-1	LowQuality
AACCATGTCGCATGGC-1	GoodQuality
AACCATGTCGGTTCGG-1	LowQuality
AACCGCGAGGGAAACA-1	GoodQuality
AACCGCGAGGTCATCT-1	GoodQuality
AACCGCGAGTACTTGC-1	GoodQuality
AACCGCGAGTTAGCGG-1	GoodQuality
AACCGCGCAAGACACG-1	GoodQuality
AACCGCGCAAGGCTCC-1	LowQuality
AACCGCGCAGTCGTGC-1	GoodQuality
AACCGCGCATGTAAGA-1	LowQuality
AACCGCGGTACACCGC-1	GoodQuality
AACCGCGGTCTAGCGC-1	GoodQuality
AACCGCGGTGAGGGTT-1	LowQuality
AACCGCGGTGTCCTCT-1	GoodQuality
AACCGCGGTTCATGGT-1	GoodQuality
AACCGCGGTTGGACCC-1	LowQuality
AACCGCGTCAGCGACC-1	LowQuality
AACCGCGTCCGCAGTG-1	GoodQuality
AACCGCGTCCTCAACC-1	GoodQuality
AACCGCGTCCTTCAAT-1	LowQuality
AACCGCGTCTTGAGGT-1	GoodQuality
AACCGCGTCTTGCATT-1	LowQuality
AACGTTGCAGTCAGCC-1	GoodQuality
AACGTTGGTCTAGGTT-1	GoodQuality
AACGTTGGTCTAGTGT-1	LowQuality
AACGTTGGTTAAAGTG-1	GoodQuality
AACTCAGAGGGAAACA-1	GoodQuality
AACTCAGCAATGAAAC-1	LowQuality
AACTCAGCACCTTGTC-1	GoodQuality
AACTCAGGTCACTGGC-1	GoodQuality
AACTCAGGTCTCAACA-1	GoodQuality
AACTCAGGTTGTCTTT-1	LowQuality
AACTCAGTCCCGGATG-1	GoodQuality
AACTCAGTCGAGAACG-1	GoodQuality
AACTCAGTCTACGAGT-1	GoodQuality
AACTCCCAGATGAGAG-1	LowQuality
AACTCCCAGGGCTTGA-1	LowQuality
AACTCCCCAAGTACCT-1	GoodQuality
AACTCCCCATGGAATA-1	LowQuality
AACTCCCCATTAGGCT-1	GoodQuality
AACTCCCGTACGCTGC-1	GoodQuality
AACTCCCGTCCAGTTA-1	GoodQuality
AACTCCCGTTCGGCAC-1	GoodQuality
AACTCCCGTTGCGCAC-1	LowQuality
AACTCCCTCAACACCA-1	GoodQuality
AACTCCCTCCCGGATG-1	GoodQuality
AACTCCCTCGCAAACT-1	LowQuality
AACTCTTAGACGCAAC-1	GoodQuality
AACTCTTAGAGCCTAG-1	LowQuality
AACTCTTAGGATGTAT-1	GoodQuality
AACTCTTCAAACAACA-1	GoodQuality
AACTCTTCACCGCTAG-1	LowQuality
AACTCTTCAGATGGGT-1	GoodQuality
AACTCTTCATTAGCCA-1	LowQuality
AACTCTTTCAGTTTGG-1	LowQuality
AACTCTTTCGAGAGCA-1	LowQuality
AACTGGTCAATTCCTT-1	GoodQuality
AACTGGTCACTTGGAT-1	GoodQuality
AACTGGTGTATGCTTG-1	LowQuality
AACTGGTGTCACACGC-1	LowQuality
AACTGGTGTGATAAAC-1	GoodQuality
AACTGGTGTTACCGAT-1	LowQuality
AACTGGTTCACGCGGT-1	GoodQuality
AACTGGTTCACTGGGC-1	GoodQuality
AACTGGTTCATTATCC-1	GoodQuality
AACTTTCAGCTGAAAT-1	GoodQuality
AACTTTCAGTTAGCGG-1	GoodQuality
AACTTTCCACATGACT-1	GoodQuality
AACTTTCCACATGGGA-1	LowQuality
AACTTTCCAGATGGGT-1	GoodQuality
AACTTTCCAGCTGCAC-1	GoodQuality
AACTTTCCAGGAATCG-1	GoodQuality
AACTTTCGTGCAACTT-1	LowQuality
AACTTTCTCTCTAAGG-1	GoodQuality
AACTTTCTCTTCTGGC-1	GoodQuality
AACTTTCTCTTGTACT-1	LowQuality
AAGACCTCAAGGACTG-1	LowQuality
AAGACCTCAATCCAAC-1	LowQuality
AAGACCTCATACTCTT-1	GoodQuality
AAGACCTGTAGAGGAA-1	GoodQuality
AAGACCTGTCGACTAT-1	GoodQuality
AAGACCTGTGTAACGG-1	GoodQuality
AAGACCTTCAGTTGAC-1	LowQuality
AAGACCTTCGCCTGAG-1	GoodQuality
AAGACCTTCGTGGTCG-1	GoodQuality
AAGACCTTCTGATACG-1	GoodQuality
AAGCCGCAGCGTGAGT-1	GoodQuality
AAGCCGCAGGCTAGAC-1	GoodQuality
AAGCCGCCAAACGTGG-1	LowQuality
AAGCCGCGTCGAACAG-1	GoodQuality
AAGCCGCGTTCGGCAC-1	GoodQuality
AAGCCGCGTTCGGGCT-1	GoodQuality
AAGCCGCTCAGCGACC-1	GoodQuality
AAGCCGCTCCCATTTA-1	LowQuality
AAGCCGCTCCCTTGCA-1	GoodQuality
AAGCCGCTCTCATTCA-1	GoodQuality
AAGCCGCTCTTGTATC-1	GoodQuality
AAGGAGCAGAACAACT-1	GoodQuality
AAGGAGCAGGACACCA-1	GoodQuality
AAGGAGCCACTAGTAC-1	LowQuality
AAGGAGCCATCTACGA-1	LowQuality
AAGGAGCGTAACGTTC-1	GoodQuality
AAGGAGCGTTCATGGT-1	GoodQuality
AAGGAGCTCCTGCAGG-1	GoodQuality
AAGGCAGAGCTCCTCT-1	GoodQuality
AAGGCAGCAAAGCGGT-1	LowQuality
AAGGCAGCAAAGTCAA-1	GoodQuality
AAGGCAGCAGCTGTAT-1	GoodQuality
AAGGCAGCATGTCGAT-1	GoodQuality
AAGGCAGGTGCCTGCA-1	GoodQuality
AAGGCAGGTTCAGACT-1	LowQuality
AAGGCAGTCGGCGCAT-1	GoodQuality
AAGGCAGTCTTTAGTC-1	LowQuality
AAGGTTCAGCAATATG-1	GoodQuality
AAGGTTCAGCCAGAAC-1	GoodQuality
AAGGTTCAGCTGCCCA-1	LowQuality
AAGGTTCAGGAGCGAG-1	GoodQuality
AAGGTTCCACTTCTGC-1	GoodQuality
AAGGTTCCAGATAATG-1	LowQuality
AAGGTTCCAGGAATGC-1	GoodQuality
AAGGTTCCAGGGATTG-1	LowQuality
AAGGTTCCAGTCGTGC-1	LowQuality
AAGGTTCGTAGGAGTC-1	GoodQuality
AAGGTTCGTCAGAGGT-1	GoodQuality
AAGGTTCGTCGGCATC-1	GoodQuality
AAGGTTCGTGCAGACA-1	LowQuality
AAGGTTCTCAACCAAC-1	GoodQuality
AAGGTTCTCACCTCGT-1	GoodQuality
AAGGTTCTCACCTTAT-1	GoodQuality
AAGGTTCTCAGCACAT-1	LowQuality
AAGGTTCTCTTGTTTG-1	GoodQuality
AAGTCTGAGATAGTCA-1	GoodQuality
AAGTCTGCAACTGCTA-1	LowQuality
AAGTCTGCACAGGCCT-1	LowQuality
AAGTCTGCACATGGGA-1	GoodQuality
AAGTCTGCATGCCTTC-1	GoodQuality
AAGTCTGGTAACGCGA-1	GoodQuality
AAGTCTGGTCATCCCT-1	GoodQuality
AAGTCTGGTCGCCATG-1	LowQuality
AAGTCTGTCAAGAAGT-1	LowQuality
AAGTCTGTCATTGCCC-1	GoodQuality
AAGTCTGTCGTGGACC-1	GoodQuality
AAGTCTGTCTTAACCT-1	GoodQuality
AATCCAGAGATGGCGT-1	GoodQuality
AATCCAGAGTGTCCCG-1	LowQuality
AATCCAGGTACCGGCT-1	GoodQuality
AATCCAGGTATATGAG-1	LowQuality
AATCCAGGTCCGACGT-1	LowQuality
AATCCAGTCCGGGTGT-1	GoodQuality
AATCCAGTCTCGGACG-1	GoodQuality
AATCGGTAGAAGCCCA-1	GoodQuality
AATCGGTCACCCATGG-1	GoodQuality
AATCGGTCACGGTTTA-1	GoodQuality
AATCGGTGTACCGTAT-1	GoodQuality
AATCGGTGTATAGGGC-1	GoodQuality
AATCGGTGTTAAGTAG-1	LowQuality
AATCGGTTCTACCAGA-1	GoodQuality
ACACCAAAGCCAGGAT-1	GoodQuality
ACACCAAAGGAGCGTT-1	LowQuality
ACACCAACACCGGAAA-1	LowQuality
ACACCAACACGGCCAT-1	LowQuality
ACACCAACATTGGTAC-1	GoodQuality
ACACCAAGTAAAGGAG-1	GoodQuality
ACACCAAGTATCAGTC-1	GoodQuality
ACACCAAGTCACCCAG-1	GoodQuality
ACACCAAGTGAGTATA-1	GoodQuality
ACACCAATCCAGGGCT-1	GoodQuality
ACACCAATCTCTGAGA-1	GoodQuality
ACACCCTAGAGACGAA-1	LowQuality
ACACCCTAGAGCTGCA-1	GoodQuality
ACACCCTAGCGTCAAG-1	GoodQuality
ACACCCTAGTGATCGG-1	LowQuality
ACACCCTCAAAGGTGC-1	LowQuality
ACACCCTCATGCCTAA-1	LowQuality
ACACCCTCATGGGACA-1	GoodQuality
ACACCCTGTAATCGTC-1	GoodQuality
ACACCCTGTACTCGCG-1	GoodQuality
ACACCCTGTAGGGACT-1	GoodQuality
ACACCCTTCAATCACG-1	GoodQuality
ACACCCTTCCGCGTTT-1	GoodQuality
ACACCGGCACACCGCA-1	GoodQuality
ACACCGGGTTCGCTAA-1	LowQuality
ACACCGGTCACCACCT-1	LowQuality
ACACCGGTCTTCGAGA-1	GoodQuality
ACACTGAAGCTAAGAT-1	GoodQuality
ACACTGACACCTCGGA-1	GoodQuality
ACACTGACATGTCCTC-1	LowQuality
ACACTGAGTGACGGTA-1	LowQuality
ACACTGAGTGAGGCTA-1	LowQuality
ACACTGAGTTATTCTC-1	GoodQuality
ACACTGAGTTCCACTC-1	LowQuality
ACACTGATCAGGTAAA-1	LowQuality
ACACTGATCCAAAGTC-1	LowQuality
ACACTGATCCGAAGAG-1	GoodQuality
ACACTGATCCGGCACA-1	LowQuality
ACACTGATCCTTGCCA-1	GoodQuality
ACAGCCGCACGGATAG-1	LowQuality
ACAGCCGCAGCCTGTG-1	GoodQuality
ACAGCCGGTATGAAAC-1	GoodQuality
ACAGCCGGTCTAACGT-1	GoodQuality
ACAGCCGGTGATGTGG-1	GoodQuality
ACAGCCGGTTCAGCGC-1	GoodQuality
ACAGCCGGTTTAAGCC-1	GoodQuality
ACAGCCGTCACATACG-1	LowQuality
ACAGCCGTCATGCTCC-1	GoodQuality
ACAGCCGTCATTTGGG-1	LowQuality
ACAGCCGTCCTACAGA-1	GoodQuality
ACAGCTAAGCACCGTC-1	LowQuality
ACAGCTAAGGATGGTC-1	GoodQuality
ACAGCTAAGGGTCTCC-1	GoodQuality
ACAGCTAAGTACATGA-1	LowQuality
ACAGCTACAATAGCGG-1	GoodQuality
ACAGCTAGTTGACGTT-1	GoodQuality
ACAGCTATCCTCATTA-1	LowQuality
ACAGCTATCCTGTACC-1	GoodQuality
ACAGCTATCTAACCGA-1	LowQuality
ACAGCTATCTTGCAAG-1	GoodQuality
ACATACGAGAAGGCCT-1	LowQuality
ACATACGAGGTTCCTA-1	GoodQuality
ACATACGCAGCTATTG-1	LowQuality
ACATACGCAGTCAGAG-1	GoodQuality
ACATACGCATCGATTG-1	LowQuality
ACATACGGTGCAGTAG-1	GoodQuality
ACATACGGTTTCCACC-1	LowQuality
ACATACGTCAAGATCC-1	GoodQuality
ACATACGTCCGCATAA-1	LowQuality
ACATACGTCGCATGGC-1	GoodQuality
ACATACGTCGTCACGG-1	LowQuality
ACATACGTCTCCAACC-1	LowQuality
ACATACGTCTGCCCTA-1	GoodQuality
ACATCAGAGCAGACTG-1	GoodQuality
ACATCAGAGTACGACG-1	LowQuality
ACATCAGCACTTCTGC-1	GoodQuality
ACATCAGCAGACAAGC-1	LowQuality
ACATCAGCATCCTTGC-1	GoodQuality
ACATCAGGTCGAACAG-1	LowQuality
ACATCAGGTGGTCCGT-1	GoodQuality
ACATCAGTCAATAAGG-1	LowQuality
ACATCAGTCCTACAGA-1	LowQuality
ACATCAGTCGTTGCCT-1	GoodQuality
ACATGGTCAAGAAAGG-1	GoodQuality
ACATGGTCATTGAGCT-1	GoodQuality
ACATGGTGTACGCACC-1	GoodQuality
ACATGGTGTCACACGC-1	LowQuality
ACATGGTGTCCGCTGA-1	GoodQuality
ACCAGTAAGCGATCCC-1	GoodQuality
ACCAGTAAGCGCTTAT-1	GoodQuality
ACCAGTAAGTACGTTC-1	GoodQuality
ACCAGTAAGTGCCATT-1	LowQuality
ACCAGTAAGTGTACCT-1	LowQuality
ACCAGTACAGCGTCCA-1	GoodQuality
ACCAGTACATTAGCCA-1	GoodQuality
ACCAGTACATTATCTC-1	LowQuality
ACCAGTAGTCCGCTGA-1	GoodQuality
ACCAGTAGTCTAAAGA-1	LowQuality
ACCAGTAGTTGCCTCT-1	GoodQuality
ACCAGTATCCAGGGCT-1	GoodQuality
ACCAGTATCGAACGGA-1	GoodQuality
ACCAGTATCTCTAGGA-1	LowQuality
ACCAGTATCTGATTCT-1	GoodQuality
ACCAGTATCTTCCTTC-1	GoodQuality
ACCCACTAGGAGTTGC-1	LowQuality
ACCCACTCATAGGATA-1	GoodQuality
ACCCACTCATCATCCC-1	LowQuality
ACCCACTGTAAATACG-1	GoodQuality
ACCCACTGTAAATGAC-1	GoodQuality
ACCCACTGTACATCCA-1	LowQuality
ACCCACTGTACCGGCT-1	GoodQuality
ACCCACTGTTCGTCTC-1	GoodQuality
ACCCACTTCAGTTAGC-1	GoodQuality
ACCCACTTCTTGACGA-1	GoodQuality
ACCGTAAAGGATATAC-1	GoodQuality
ACCGTAAAGGCAATTA-1	LowQuality
ACCGTAAAGTATCGAA-1	GoodQuality
ACCGTAACAAAGGCGT-1	GoodQuality
ACCGTAACACGTGAGA-1	LowQuality
ACCGTAACAGTGGGAT-1	GoodQuality
ACCGTAAGTCACTGGC-1	GoodQuality
ACCGTAAGTCGACTAT-1	GoodQuality
ACCGTAATCAAACCGT-1	LowQuality
ACCGTAATCACCACCT-1	LowQuality
ACCGTAATCGAGAGCA-1	GoodQuality
ACCGTAATCTAGCACA-1	GoodQuality
ACCGTAATCTATGTGG-1	GoodQuality
ACCTTTAAGGCTAGAC-1	GoodQuality
ACCTTTAAGTGGGCTA-1	GoodQuality
ACCTTTAAGTGTACTC-1	LowQuality
ACCTTTACAGCTTAAC-1	LowQuality
ACCTTTAGTCTAGGTT-1	LowQuality
ACCTTTAGTGCACTTA-1	LowQuality
ACCTTTAGTGCTTCTC-1	GoodQuality
ACCTTTATCGTAGGTT-1	LowQuality
ACCTTTATCGTGGACC-1	LowQuality
ACGAGCCAGGATGTAT-1	LowQuality
ACGAGCCCACCACGTG-1	GoodQuality
ACGAGCCCACCCTATC-1	GoodQuality
ACGAGCCGTCAATACC-1	GoodQuality
ACGAGCCGTCCAAGTT-1	GoodQuality
ACGAGCCGTGCAGGTA-1	GoodQuality
ACGAGCCGTTACGACT-1	GoodQuality
ACGAGCCTCAACTCTT-1	LowQuality
ACGAGCCTCATGCATG-1	GoodQuality
ACGAGCCTCCGCGTTT-1	LowQuality
ACGAGCCTCCTTGCCA-1	GoodQuality
ACGAGGAAGAGTGACC-1	GoodQuality
ACGAGGAAGGAGTCTG-1	GoodQuality
ACGAGGACAGACACTT-1	GoodQuality
ACGAGGACAGGACGTA-1	LowQuality
ACGAGGACAGGTGCCT-1	GoodQuality
ACGAGGACATATGAGA-1	GoodQuality
ACGAGGAGTAAGTGTA-1	GoodQuality
ACGAGGAGTACATGTC-1	GoodQuality
ACGAGGAGTGCAGTAG-1	GoodQuality
ACGAGGATCACAGTAC-1	LowQuality
ACGAGGATCACGCGGT-1	GoodQuality
ACGAGGATCACTCCTG-1	GoodQuality
ACGAGGATCAGCACAT-1	GoodQuality
ACGATACAGACTAAGT-1	GoodQuality
ACGATACAGCAAATCA-1	GoodQuality
ACGATACAGGCCCTCA-1	GoodQuality
ACGATACAGTACCGGA-1	GoodQuality
ACGATACCAGCCACCA-1	GoodQuality
ACGATACGTCTCGTTC-1	GoodQuality
ACGATACGTTCGCGAC-1	LowQuality
ACGATACTCACCTCGT-1	GoodQuality
ACGATACTCGAATGCT-1	GoodQuality
ACGATGTAGCACCGCT-1	GoodQuality
ACGATGTCAACCGCCA-1	GoodQuality
ACGATGTCAAGCCGTC-1	GoodQuality
ACGATGTCACAGGAGT-1	LowQuality
ACGATGTCAGGTTTCA-1	GoodQuality
ACGATGTGTAAGTGTA-1	GoodQuality
ACGATGTGTTCATGGT-1	LowQuality
ACGATGTGTTCCCGAG-1	GoodQuality
ACGATGTTCACCACCT-1	GoodQuality
ACGATGTTCATGTCTT-1	GoodQuality
ACGATGTTCCACGCAG-1	GoodQuality
ACGATGTTCCACTCCA-1	LowQuality
ACGATGTTCTCTTATG-1	GoodQuality
ACGCAGCAGGGCTTCC-1	GoodQuality
ACGCAGCAGTACCGGA-1	GoodQuality
ACGCAGCCAGGACCCT-1	GoodQuality
ACGCAGCCAGTATAAG-1	GoodQuality
ACGCAGCCATTCCTGC-1	GoodQuality
ACGCAGCGTATATCCG-1	GoodQuality
ACGCAGCGTATCTGCA-1	LowQuality
ACGCAGCGTTCTGAAC-1	LowQuality
ACGCAGCTCGCGTAGC-1	GoodQuality
ACGCCAGAGATCCCGC-1	GoodQuality
ACGCCAGAGCCTCGTG-1	GoodQuality
ACGCCAGAGTAGTGCG-1	LowQuality
ACGCCAGCAAAGCAAT-1	GoodQuality
ACGCCAGCAGTTAACC-1	GoodQuality
ACGCCAGGTAAAGGAG-1	GoodQuality
ACGCCAGGTGTTAAGA-1	GoodQuality
ACGCCAGGTTACGCGC-1	GoodQuality
ACGCCAGTCCCGGATG-1	LowQuality
ACGCCAGTCTGAGGGA-1	GoodQuality
ACGCCGAAGATCCCGC-1	GoodQuality
ACGCCGACAATGAATG-1	GoodQuality
ACGCCGACAATGCCAT-1	GoodQuality
ACGCCGAGTAAACCTC-1	LowQuality
ACGCCGAGTCCAGTAT-1	GoodQuality
ACGCCGAGTCGACTAT-1	GoodQuality
ACGCCGAGTCTCGTTC-1	GoodQuality
ACGCCGATCTGATACG-1	LowQuality
ACGGAGAAGAGCAATT-1	LowQuality
ACGGAGACACCATCCT-1	GoodQuality
ACGGAGACATTCGACA-1	LowQuality
ACGGAGACATTTCACT-1	GoodQuality
ACGGAGAGTAGCTAAA-1	LowQuality
ACGGAGAGTGGGTCAA-1	LowQuality
ACGGAGAGTTGCTCCT-1	LowQuality
ACGGAGATCCGAGCCA-1	GoodQuality
ACGGAGATCCGTTGCT-1	GoodQuality
ACGGAGATCGTAGGTT-1	LowQuality
ACGGAGATCTGAGGGA-1	LowQuality
ACGGCCAAGCCGCCTA-1	LowQuality
ACGGCCAAGCGTGAAC-1	GoodQuality
ACGGCCACACCAGCAC-1	GoodQuality
ACGGCCACACGCCAGT-1	GoodQuality
ACGGCCACAGTTCATG-1	LowQuality
ACGGCCAGTGCGAAAC-1	GoodQuality
ACGGCCATCCTTTACA-1	GoodQuality
ACGGCCATCTCTTATG-1	GoodQuality
ACGGGCTAGAGTGACC-1	LowQuality
ACGGGCTCAGGAACGT-1	GoodQuality
ACGGGCTTCACCGTAA-1	LowQuality
ACGGGCTTCATTGCGA-1	GoodQuality
ACGGGCTTCGGATGTT-1	GoodQuality
ACGGGCTTCTATCCTA-1	GoodQuality
ACGGGCTTCTTAGCCC-1	GoodQuality
ACGGGTCAGAGCCCAA-1	GoodQuality
ACGGGTCAGCAGGTCA-1	GoodQuality
ACGGGTCAGCCACTAT-1	GoodQuality
ACGGGTCAGTCACGCC-1	GoodQuality
ACGGGTCCAAAGTGCG-1	GoodQuality
ACGGGTCCATACTCTT-1	GoodQuality
ACGGGTCGTAAATGTG-1	GoodQuality
ACGGGTCGTACAAGTA-1	GoodQuality
ACGGGTCTCACTGGGC-1	GoodQuality
ACGGGTCTCGTATCAG-1	GoodQuality
ACGTCAAAGCGTCTAT-1	GoodQuality
ACGTCAACAAGCCCAC-1	GoodQuality
ACGTCAACACATTAGC-1	LowQuality
ACGTCAACATATACCG-1	LowQuality
ACGTCAAGTACCGAGA-1	GoodQuality
ACGTCAAGTAGCAAAT-1	LowQuality
ACGTCAAGTCATCCCT-1	LowQuality
ACGTCAAGTCTGCCAG-1	GoodQuality
ACGTCAAGTGCAGACA-1	GoodQuality
ACTATCTCACGGTAAG-1	LowQuality
ACTATCTCAGTGAGTG-1	GoodQuality
ACTATCTGTGTTGGGA-1	GoodQuality
ACTATCTTCGCCAAAT-1	GoodQuality
ACTATCTTCTAAGCCA-1	GoodQuality
ACTGAACAGACAGAGA-1	GoodQuality
ACTGAACAGTTATCGC-1	GoodQuality
ACTGAACCACACGCTG-1	LowQuality
ACTGAACCAGCTTAAC-1	GoodQuality
ACTGAACCATACAGCT-1	LowQuality
ACTGAACCATTGGTAC-1	LowQuality
ACTGAACGTAAGTGGC-1	GoodQuality
ACTGAACGTAGCGTAG-1	GoodQuality
ACTGAACGTAGGGACT-1	GoodQuality
ACTGAACGTCAAAGAT-1	LowQuality
ACTGAACGTTAAGACA-1	GoodQuality
ACTGAACTCGAATCCA-1	GoodQuality
ACTGAACTCTACCTGC-1	LowQuality
ACTGAGTAGGAGTTTA-1	GoodQuality
ACTGAGTAGTAGATGT-1	LowQuality
ACTGAGTCAAGCCGTC-1	GoodQuality
ACTGAGTGTAAACACA-1	LowQuality
ACTGAGTGTGGAAAGA-1	GoodQuality
ACTGAGTGTGTGGCTC-1	GoodQuality
ACTGAGTTCAGCGATT-1	GoodQuality
ACTGAGTTCCTAGGGC-1	GoodQuality
ACTGAGTTCGCCCTTA-1	GoodQuality
ACTGAGTTCTGATACG-1	GoodQuality
ACTGAGTTCTGCCAGG-1	GoodQuality
ACTGATGAGGCGATAC-1	GoodQuality
ACTGATGCAGACAGGT-1	GoodQuality
ACTGATGCATTTGCTT-1	GoodQuality
ACTGATGGTGACGCCT-1	GoodQuality
ACTGATGGTGGTTTCA-1	GoodQuality
ACTGATGTCAAAGACA-1	LowQuality
ACTGATGTCGGAGGTA-1	GoodQuality
ACTGATGTCTCGATGA-1	GoodQuality
ACTGATGTCTGCTGTC-1	GoodQuality
ACTGCTCAGCGCCTTG-1	GoodQuality
ACTGCTCAGGGTCGAT-1	GoodQuality
ACTGCTCCACCGAAAG-1	LowQuality
ACTGCTCGTCTTGTCC-1	GoodQuality
ACTGCTCGTGCCTTGG-1	GoodQuality
ACTGCTCGTGTTGGGA-1	GoodQuality
ACTGCTCGTTTAGGAA-1	GoodQuality
ACTGCTCTCCTATTCA-1	GoodQuality
ACTGCTCTCTGGCGAC-1	GoodQuality
ACTGCTCTCTTGTTTG-1	LowQuality
ACTGTCCAGAGTCTGG-1	GoodQuality
ACTGTCCAGTTTCCTT-1	LowQuality
ACTGTCCCAAGCCCAC-1	LowQuality
ACTGTCCCACCGGAAA-1	GoodQuality
ACTGTCCGTTACTGAC-1	GoodQuality
ACTGTCCGTTTGACAC-1	GoodQuality
ACTGTCCTCACCCTCA-1	GoodQuality
ACTGTCCTCCACGTTC-1	GoodQuality
ACTTACTAGTTGTAGA-1	LowQuality
ACTTACTCACTTAACG-1	GoodQuality
ACTTACTCAGATAATG-1	GoodQuality
ACTTACTCATTTCACT-1	GoodQuality
ACTTACTGTAGATTAG-1	GoodQuality
ACTTACTGTCACACGC-1	GoodQuality
ACTTACTGTCTCTTTA-1	GoodQuality
ACTTACTGTGATGCCC-1	GoodQuality
ACTTACTTCGGATGGA-1	GoodQuality
ACTTACTTCTACTTAC-1	GoodQuality
ACTTGTTAGAGTGACC-1	LowQuality
ACTTGTTAGGAATCGC-1	GoodQuality
ACTTGTTAGTGGTAAT-1	GoodQuality
ACTTGTTAGTTGTCGT-1	GoodQuality
ACTTGTTCACAAGCCC-1	LowQuality
ACTTGTTCAGTAAGCG-1	LowQuality
ACTTGTTGTACTCGCG-1	GoodQuality
ACTTGTTGTCTAGAGG-1	GoodQuality
ACTTGTTTCATATCGG-1	LowQuality
ACTTGTTTCGAATCCA-1	LowQuality
ACTTGTTTCTGTCCGT-1	GoodQuality
ACTTTCAAGGTAGCCA-1	LowQuality
ACTTTCACACGGTAAG-1	GoodQuality
ACTTTCACAGGAACGT-1	GoodQuality
ACTTTCACATTAGCCA-1	GoodQuality
ACTTTCAGTCCGACGT-1	LowQuality
ACTTTCAGTCTCCACT-1	GoodQuality
ACTTTCAGTGCCTGTG-1	GoodQuality
ACTTTCATCACCGGGT-1	GoodQuality
ACTTTCATCATTCACT-1	LowQuality
ACTTTCATCGGCTACG-1	LowQuality
AGAATAGAGCTCCCAG-1	GoodQuality
AGAATAGAGGTAGCTG-1	GoodQuality
AGAATAGAGTCTCAAC-1	LowQuality
AGAATAGGTTAAGACA-1	GoodQuality
AGAATAGTCCTGTACC-1	GoodQuality
AGACGTTAGAAACCAT-1	GoodQuality
AGACGTTAGACGACGT-1	LowQuality
AGACGTTAGTTGCAGG-1	GoodQuality
AGACGTTCAACTTGAC-1	LowQuality
AGACGTTCACAACGCC-1	LowQuality
AGACGTTCATAACCTG-1	LowQuality
AGACGTTCATATGAGA-1	GoodQuality
AGACGTTCATGGTCAT-1	GoodQuality
AGACGTTGTCCGTGAC-1	LowQuality
AGACGTTGTGAGGGTT-1	GoodQuality
AGACGTTGTTCATGGT-1	GoodQuality
AGACGTTGTTTGGGCC-1	GoodQuality
AGACGTTTCAATCTCT-1	GoodQuality
AGACGTTTCACCATAG-1	GoodQuality
AGACGTTTCCTATTCA-1	GoodQuality
AGAGCGAAGAGAACAG-1	GoodQuality
AGAGCGAAGATGGGTC-1	GoodQuality
AGAGCGAAGTATCTCG-1	GoodQuality
AGAGCGACAATGACCT-1	GoodQuality
AGAGCGACAATGTTGC-1	GoodQuality
AGAGCGACAGCATGAG-1	GoodQuality
AGAGCGACATCGGAAG-1	GoodQuality
AGAGCGACATGGTTGT-1	GoodQuality
AGAGCGAGTGGTCCGT-1	LowQuality
AGAGCGATCCCTTGTG-1	LowQuality
AGAGCGATCGAGCCCA-1	GoodQuality
AGAGCGATCGCAAACT-1	GoodQuality
AGAGCGATCTACCTGC-1	LowQuality
AGAGCTTCAAGTTGTC-1	GoodQuality
AGAGCTTGTCCGAATT-1	LowQuality
AGAGCTTGTGCAACGA-1	GoodQuality
AGAGCTTGTTACCAGT-1	GoodQuality
AGAGCTTGTTGCGTTA-1	GoodQuality
AGAGCTTGTTTGTTGG-1	GoodQuality
AGAGTGGAGTCAATAG-1	GoodQuality
AGAGTGGCAACTGGCC-1	GoodQuality
AGAGTGGCATAGACTC-1	GoodQuality
AGAGTGGCATCCCATC-1	GoodQuality
AGAGTGGGTCTTCTCG-1	LowQuality
AGAGTGGGTGTTAAGA-1	GoodQuality
AGAGTGGTCATCATTC-1	GoodQuality
AGATCTGAGATATGGT-1	GoodQuality
AGATCTGAGCGTGAAC-1	LowQuality
AGATCTGAGCGTTTAC-1	LowQuality
AGATCTGAGCTATGCT-1	GoodQuality
AGATCTGAGTACGTAA-1	GoodQuality
AGATCTGAGTAGATGT-1	LowQuality
AGATCTGCACCAGATT-1	LowQuality
AGATCTGCACCCTATC-1	GoodQuality
AGATCTGGTACTTAGC-1	LowQuality
AGATCTGTCACGACTA-1	LowQuality
AGATCTGTCCAGGGCT-1	GoodQuality
AGATTGCAGCGTGAGT-1	LowQuality
AGATTGCAGCTCAACT-1	GoodQuality
AGATTGCAGGAATTAC-1	GoodQuality
AGATTGCCAAAGGAAG-1	GoodQuality
AGATTGCCAAATTGCC-1	GoodQuality
AGATTGCCAGTGGGAT-1	LowQuality
AGATTGCGTATATCCG-1	GoodQuality
AGATTGCGTCAGAATA-1	LowQuality
AGATTGCGTCTCAACA-1	GoodQuality
AGATTGCGTTCCACAA-1	GoodQuality
AGATTGCGTTCCACTC-1	GoodQuality
AGATTGCTCCAAATGC-1	GoodQuality
AGATTGCTCCGCAGTG-1	GoodQuality
AGATTGCTCGCGATCG-1	GoodQuality
AGCAGCCAGGCCCGTT-1	LowQuality
AGCAGCCAGTGTGGCA-1	GoodQuality
AGCAGCCCACGTGAGA-1	GoodQuality
AGCAGCCGTTACCAGT-1	GoodQuality
AGCAGCCTCAATAAGG-1	LowQuality
AGCAGCCTCCCACTTG-1	LowQuality
AGCAGCCTCCCAGGTG-1	LowQuality
AGCATACAGAGTACAT-1	LowQuality
AGCATACAGCGCCTTG-1	GoodQuality
AGCATACAGGTAGCCA-1	GoodQuality
AGCATACCAACACGCC-1	LowQuality
AGCATACCACGTCTCT-1	GoodQuality
AGCATACGTCAGGACA-1	LowQuality
AGCATACGTGGTTTCA-1	LowQuality
AGCATACTCGCCAGCA-1	GoodQuality
AGCATACTCTAGCACA-1	GoodQuality
AGCCTAAAGAAGATTC-1	GoodQuality
AGCCTAAAGCTACCGC-1	GoodQuality
AGCCTAAAGGCATGTG-1	GoodQuality
AGCCTAAAGGTCATCT-1	GoodQuality
AGCCTAAAGTATTGGA-1	LowQuality
AGCCTAACAAGCCGCT-1	LowQuality
AGCCTAACACGTAAGG-1	GoodQuality
AGCCTAACAGATAATG-1	LowQuality
AGCCTAACATACTCTT-1	GoodQuality
AGCCTAACATGACGGA-1	GoodQuality
AGCCTAAGTAAGTGTA-1	GoodQuality
AGCCTAAGTACCGAGA-1	GoodQuality
AGCCTAAGTACTTGAC-1	LowQuality
AGCCTAAGTCCGAACC-1	GoodQuality
AGCCTAAGTCCGAGTC-1	GoodQuality
AGCCTAAGTTGACGTT-1	LowQuality
AGCCTAATCCTAGTGA-1	GoodQuality
AGCCTAATCGTTGACA-1	GoodQuality
AGCCTAATCTCTGTCG-1	LowQuality
AGCCTAATCTGGAGCC-1	GoodQuality
AGCGGTCAGGATGGTC-1	GoodQuality
AGCGGTCAGGCATTGG-1	LowQuality
AGCGGTCAGTGGTCCC-1	GoodQuality
AGCGGTCCAATGAAAC-1	LowQuality
AGCGGTCCAATGACCT-1	GoodQuality
AGCGGTCCACGTCAGC-1	LowQuality
AGCGGTCCAGACTCGC-1	GoodQuality
AGCGGTCCAGCTATTG-1	GoodQuality
AGCGGTCCATCCCACT-1	LowQuality
AGCGGTCGTTATTCTC-1	GoodQuality
AGCGGTCTCAGCGACC-1	LowQuality
AGCGGTCTCTCTGAGA-1	LowQuality
AGCGTATAGTAGTGCG-1	GoodQuality
AGCGTATCACGAAAGC-1	GoodQuality
AGCGTATCACGGACAA-1	LowQuality
AGCGTATCAGTATCTG-1	GoodQuality
AGCGTATTCACCCGAG-1	LowQuality
AGCGTATTCTATGTGG-1	GoodQuality
AGCGTATTCTCAAGTG-1	LowQuality
AGCGTCGAGTGGACGT-1	GoodQuality
AGCGTCGCAGGTTTCA-1	GoodQuality
AGCGTCGGTAGGAGTC-1	GoodQuality
AGCGTCGGTCTCTCTG-1	GoodQuality
AGCGTCGTCATTGCCC-1	GoodQuality
AGCGTCGTCCAGAAGG-1	GoodQuality
AGCGTCGTCCCTCAGT-1	LowQuality
AGCGTCGTCGGACAAG-1	GoodQuality
AGCGTCGTCGGAGCAA-1	GoodQuality
AGCGTCGTCGTTGCCT-1	LowQuality
AGCGTCGTCTAACGGT-1	GoodQuality
AGCGTCGTCTGGCGAC-1	LowQuality
AGCTCCTAGGTGATAT-1	LowQuality
AGCTCCTCAACGATCT-1	GoodQuality
AGCTCCTCAATGTTGC-1	GoodQuality
AGCTCCTGTAGCCTCG-1	GoodQuality
AGCTCCTGTCACACGC-1	LowQuality
AGCTCCTGTCTCACCT-1	LowQuality
AGCTCCTGTCTCTCTG-1	GoodQuality
AGCTCCTGTGCCTGGT-1	GoodQuality
AGCTCCTGTTCGGCAC-1	GoodQuality
AGCTCCTTCCCTCTTT-1	LowQuality
AGCTCCTTCCGTTGTC-1	GoodQuality
AGCTCCTTCTAACTGG-1	GoodQuality
AGCTCCTTCTTGTACT-1	GoodQuality
AGCTCTCAGCACCGTC-1	GoodQuality
AGCTCTCAGTAGTGCG-1	GoodQuality
AGCTCTCAGTGTCTCA-1	GoodQuality
AGCTCTCCACACAGAG-1	GoodQuality
AGCTCTCCACGAGAGT-1	GoodQuality
AGCTCTCCAGGACCCT-1	LowQuality
AGCTCTCCAGTAACGG-1	GoodQuality
AGCTCTCTCAAAGTAG-1	LowQuality
AGCTCTCTCGGAATCT-1	LowQuality
AGCTCTCTCGGTTAAC-1	GoodQuality
AGCTTGAAGAGACTAT-1	GoodQuality
AGCTTGAAGGGAGTAA-1	GoodQuality
AGCTTGACACCACCAG-1	LowQuality
AGCTTGACATTCGACA-1	GoodQuality
AGCTTGATCAGAGCTT-1	GoodQuality
AGCTTGATCCACTCCA-1	GoodQuality
AGCTTGATCGTTGACA-1	GoodQuality
AGGCCACAGCACGCCT-1	GoodQuality
AGGCCACAGTCTCGGC-1	GoodQuality
AGGCCACCAACGATGG-1	GoodQuality
AGGCCACCATGCAACT-1	GoodQuality
AGGCCACCATTTCAGG-1	GoodQuality
AGGCCACGTAAGGATT-1	LowQuality
AGGCCACGTATAAACG-1	GoodQuality
AGGCCGTCACGGTTTA-1	GoodQuality
AGGCCGTCAGGGAGAG-1	LowQuality
AGGCCGTCAGTCACTA-1	GoodQuality
AGGCCGTTCTGGTGTA-1	GoodQuality
AGGGAGTAGAGACTAT-1	LowQuality
AGGGAGTAGGCAGGTT-1	GoodQuality
AGGGAGTAGGTGCTAG-1	GoodQuality
AGGGAGTCAAGCCCAC-1	GoodQuality
AGGGAGTCAAGCCGCT-1	GoodQuality
AGGGAGTCACCTCGGA-1	GoodQuality
AGGGAGTCATGCATGT-1	GoodQuality
AGGGAGTGTAGAGCTG-1	GoodQuality
AGGGAGTGTCATCGGC-1	GoodQuality
AGGGAGTTCTTCATGT-1	GoodQuality
AGGGAGTTCTTGAGGT-1	LowQuality
AGGGATGAGCCAACAG-1	LowQuality
AGGGATGAGCTGCCCA-1	LowQuality
AGGGATGAGGATGGAA-1	GoodQuality
AGGGATGCAACGCACC-1	LowQuality
AGGGATGCATCCGTGG-1	LowQuality
AGGGATGGTAGATTAG-1	LowQuality
AGGGATGGTCGAAAGC-1	GoodQuality
AGGGATGTCCAACCAA-1	GoodQuality
AGGGATGTCTGCGACG-1	GoodQuality
AGGGTGAAGCGCTTAT-1	LowQuality
AGGGTGAAGCTAGTCT-1	GoodQuality
AGGGTGAAGTAATCCC-1	LowQuality
AGGGTGACAAAGGAAG-1	GoodQuality
AGGGTGACAGAAGCAC-1	GoodQuality
AGGGTGACAGCCAGAA-1	GoodQuality
AGGGTGAGTGAGCGAT-1	LowQuality
AGGGTGAGTTTAGGAA-1	GoodQuality
AGGGTGAGTTTGACAC-1	GoodQuality
AGGGTGATCAACCATG-1	GoodQuality
AGGGTGATCCATGCTC-1	GoodQuality
AGGGTGATCCGAACGC-1	GoodQuality
AGGGTGATCTTGTATC-1	LowQuality
AGGTCATAGTGGTCCC-1	GoodQuality
AGGTCATCAAATCCGT-1	GoodQuality
AGGTCATCACTATCTT-1	GoodQuality
AGGTCATCACTCTGTC-1	GoodQuality
AGGTCATGTGGTTTCA-1	LowQuality
AGGTCATGTTCGGGCT-1	GoodQuality
AGGTCCGAGCTACCTA-1	GoodQuality
AGGTCCGAGGTGTGGT-1	GoodQuality
AGGTCCGGTTCACCTC-1	LowQuality
AGGTCCGGTTCTCATT-1	GoodQuality
AGGTCCGTCAAACGGG-1	GoodQuality
AGGTCCGTCGCGGATC-1	LowQuality
AGGTCCGTCGGAGCAA-1	GoodQuality
AGGTCCGTCTAAGCCA-1	LowQuality
AGGTCCGTCTTGAGGT-1	GoodQuality
AGTAGTCAGCGCTTAT-1	LowQuality
AGTAGTCAGCTGATAA-1	GoodQuality
AGTAGTCAGGACAGCT-1	GoodQuality
AGTAGTCAGGCCCTTG-1	GoodQuality
AGTAGTCAGTATCTCG-1	LowQuality
AGTAGTCCATGCTAGT-1	GoodQuality
AGTAGTCGTCCCTTGT-1	GoodQuality
AGTAGTCGTTGCTCCT-1	GoodQuality
AGTAGTCTCACCACCT-1	LowQuality
AGTAGTCTCGTCTGCT-1	GoodQuality
AGTCTTTAGCGATCCC-1	GoodQuality
AGTCTTTAGCGCTCCA-1	LowQuality
AGTCTTTAGGGATACC-1	GoodQuality
AGTCTTTAGGTGGGTT-1	GoodQuality
AGTCTTTAGTCACGCC-1	GoodQuality
AGTCTTTCAGGGATTG-1	GoodQuality
AGTCTTTCAGTAAGAT-1	LowQuality
AGTCTTTCATCAGTCA-1	LowQuality
AGTCTTTCATGGTCAT-1	LowQuality
AGTCTTTGTGATAAAC-1	GoodQuality
AGTCTTTTCGGCATCG-1	GoodQuality
AGTCTTTTCTCTGCTG-1	LowQuality
AGTGAGGAGAGCAATT-1	GoodQuality
AGTGAGGAGAGTCGGT-1	LowQuality
AGTGAGGAGCAGCCTC-1	LowQuality
AGTGAGGAGGCAATTA-1	GoodQuality
AGTGAGGAGTGTCCCG-1	GoodQuality
AGTGAGGGTACGCACC-1	GoodQuality
AGTGAGGGTCTTGATG-1	LowQuality
AGTGAGGTCAGTCCCT-1	GoodQuality
AGTGAGGTCCAAACTG-1	GoodQuality
AGTGAGGTCTATCCTA-1	GoodQuality
AGTGGGAAGAAGGGTA-1	GoodQuality
AGTGGGAAGACATAAC-1	GoodQuality
AGTGGGAAGAGTCTGG-1	GoodQuality
AGTGGGAAGTGTACCT-1	GoodQuality
AGTGGGAAGTTAGGTA-1	LowQuality
AGTGGGACAGATGAGC-1	GoodQuality
AGTGGGACAGCTTCGG-1	GoodQuality
AGTGGGAGTAAGAGGA-1	LowQuality
AGTGGGAGTAGGGTAC-1	GoodQuality
AGTGGGATCGGTGTCG-1	GoodQuality
AGTGTCAAGCGTTCCG-1	LowQuality
AGTGTCAAGCGTTGCC-1	GoodQuality
AGTGTCAAGGGAAACA-1	GoodQuality
AGTGTCACAAGAGTCG-1	GoodQuality
AGTGTCACAATCCGAT-1	GoodQuality
AGTGTCACATGGTTGT-1	GoodQuality
AGTGTCAGTAGCGTAG-1	GoodQuality
AGTGTCAGTCGGGTCT-1	LowQuality
AGTGTCAGTGCCTGGT-1	LowQuality
AGTGTCAGTTGATTGC-1	GoodQuality
AGTGTCATCATGCAAC-1	GoodQuality
AGTGTCATCCTGCTTG-1	GoodQuality
AGTGTCATCGGTTCGG-1	GoodQuality
AGTGTCATCTCACATT-1	GoodQuality
AGTTGGTAGAATAGGG-1	LowQuality
AGTTGGTCACAGACAG-1	GoodQuality
AGTTGGTCACCAGGCT-1	LowQuality
AGTTGGTCACCCTATC-1	GoodQuality
AGTTGGTCATTCTTAC-1	GoodQuality
AGTTGGTGTGCAACTT-1	LowQuality
AGTTGGTTCCACGCAG-1	LowQuality
AGTTGGTTCGCAGGCT-1	GoodQuality
AGTTGGTTCTTGCCGT-1	GoodQuality
ATAACGCAGACCACGA-1	GoodQuality
ATAACGCAGAGGGATA-1	LowQuality
ATAACGCCATAGTAAG-1	GoodQuality
ATAACGCGTAGCCTAT-1	LowQuality
ATAACGCGTAGGAGTC-1	GoodQuality
ATAACGCGTAGGGTAC-1	LowQuality
ATAACGCGTTATCACG-1	LowQuality
ATAACGCTCAGTGTTG-1	GoodQuality
ATAAGAGAGAGACGAA-1	GoodQuality
ATAAGAGAGAGTCTGG-1	GoodQuality
ATAAGAGAGGTGATTA-1	GoodQuality
ATAAGAGAGTACCGGA-1	GoodQuality
ATAAGAGAGTGTCCCG-1	GoodQuality
ATAAGAGCAAATACAG-1	GoodQuality
ATAAGAGCACCCATTC-1	GoodQuality
ATAAGAGCACGCCAGT-1	LowQuality
ATAAGAGCACGGTGTC-1	GoodQuality
ATAAGAGGTATGCTTG-1	GoodQuality
ATAAGAGGTCAAAGCG-1	GoodQuality
ATAAGAGGTTCAACCA-1	GoodQuality
ATAAGAGTCCTTGGTC-1	LowQuality
ATAGACCAGCCAGAAC-1	LowQuality
ATAGACCAGCTTCGCG-1	LowQuality
ATAGACCAGTCCGGTC-1	LowQuality
ATAGACCCAATCTACG-1	GoodQuality
ATAGACCCATGTCCTC-1	GoodQuality
ATAGACCGTCAGTGGA-1	GoodQuality
ATAGACCGTCCAGTTA-1	LowQuality
ATAGACCGTCTCCATC-1	GoodQuality
ATAGACCTCAGCCTAA-1	LowQuality
ATAGACCTCCCGACTT-1	GoodQuality
ATAGACCTCCCTCTTT-1	GoodQuality
ATAGACCTCCTTTCTC-1	GoodQuality
ATAGACCTCTTAGCCC-1	GoodQuality
ATCACGAAGCTGTCTA-1	GoodQuality
ATCACGACAGGGTTAG-1	GoodQuality
ATCACGACATGGAATA-1	LowQuality
ATCACGAGTACAGTGG-1	GoodQuality
ATCACGAGTCCGTTAA-1	GoodQuality
ATCACGAGTGTTCTTT-1	GoodQuality
ATCACGAGTTTAGGAA-1	GoodQuality
ATCACGATCATACGGT-1	LowQuality
ATCACGATCATGTAGC-1	GoodQuality
ATCACGATCCCTGACT-1	LowQuality
ATCACGATCGGCGCAT-1	GoodQuality
ATCACGATCGTGGACC-1	GoodQuality
ATCACGATCTTATCTG-1	GoodQuality
ATCATCTAGAGCAATT-1	GoodQuality
ATCATCTAGATATACG-1	GoodQuality
ATCATCTAGATCGGGT-1	GoodQuality
ATCATCTAGTCATGCT-1	GoodQuality
ATCATCTAGTCGAGTG-1	LowQuality
ATCATCTAGTGTGGCA-1	GoodQuality
ATCATCTCAAAGCGGT-1	GoodQuality
ATCATCTCACATGACT-1	GoodQuality
ATCATCTCAGGATTGG-1	LowQuality
ATCATCTCAGGGTATG-1	LowQuality
ATCATCTCAGTGAGTG-1	LowQuality
ATCATCTGTACCAGTT-1	LowQuality
ATCATCTGTCTAGGTT-1	LowQuality
ATCATCTGTGGCGAAT-1	LowQuality
ATCATCTTCCCGACTT-1	GoodQuality
ATCATCTTCCGTTGCT-1	LowQuality
ATCATCTTCGGAGGTA-1	LowQuality
ATCATGGCAGGACCCT-1	GoodQuality
ATCATGGCATGTCCTC-1	GoodQuality
ATCATGGGTCGCTTCT-1	GoodQuality
ATCATGGGTTGGACCC-1	GoodQuality
ATCATGGTCATGCTCC-1	GoodQuality
ATCATGGTCATGTAGC-1	LowQuality
ATCATGGTCCTAAGTG-1	GoodQuality
ATCCACCCAATCACAC-1	LowQuality
ATCCACCGTAGCAAAT-1	GoodQuality
ATCCACCTCACTTACT-1	LowQuality
ATCCGAAAGACAATAC-1	GoodQuality
ATCCGAAAGAGCAATT-1	GoodQuality
ATCCGAAAGCTAACTC-1	GoodQuality
ATCCGAAAGGGTTCCC-1	LowQuality
ATCCGAACAATGTAAG-1	GoodQuality
ATCCGAACAGACAGGT-1	GoodQuality
ATCCGAACAGGAATGC-1	GoodQuality
ATCCGAACAGGATCGA-1	GoodQuality
ATCCGAAGTAGCTGCC-1	LowQuality
ATCCGAAGTCCAGTTA-1	LowQuality
ATCCGAAGTTACCAGT-1	GoodQuality
ATCCGAATCGCGCCAA-1	GoodQuality
ATCCGAATCTCTTATG-1	GoodQuality
ATCCGAATCTTGCAAG-1	GoodQuality
ATCGAGTAGAGCTGGT-1	GoodQuality
ATCGAGTAGCACAGGT-1	LowQuality
ATCGAGTGTAATCACC-1	GoodQuality
ATCGAGTGTAGCAAAT-1	GoodQuality
ATCGAGTGTCGTCTTC-1	LowQuality
ATCGAGTGTCTGGAGA-1	GoodQuality
ATCGAGTGTGCAGTAG-1	GoodQuality
ATCGAGTGTGGTACAG-1	GoodQuality
ATCGAGTGTTGTGGAG-1	GoodQuality
ATCGAGTTCACGCATA-1	GoodQuality
ATCGAGTTCAGCCTAA-1	GoodQuality
ATCGAGTTCATGTGGT-1	GoodQuality
ATCTACTAGGTGGGTT-1	GoodQuality
ATCTACTAGTTAACGA-1	GoodQuality
ATCTACTAGTTCCACA-1	GoodQuality
ATCTACTCAACACCTA-1	GoodQuality
ATCTACTCAGCTGTTA-1	GoodQuality
ATCTACTCATTAGGCT-1	LowQuality
ATCTACTGTACTTCTT-1	GoodQuality
ATCTACTGTGCTGTAT-1	LowQuality
ATCTACTGTGTGCGTC-1	LowQuality
ATCTACTTCGTCCGTT-1	GoodQuality
ATCTACTTCTGCCCTA-1	GoodQuality
ATCTACTTCTTCCTTC-1	GoodQuality
ATCTACTTCTTGCCGT-1	GoodQuality
ATCTACTTCTTGTATC-1	LowQuality
ATCTGCCAGACCGGAT-1	LowQuality
ATCTGCCCAACACCTA-1	GoodQuality
ATCTGCCCACCAACCG-1	LowQuality
ATCTGCCCAGTCAGCC-1	GoodQuality
ATCTGCCCATTAACCG-1	GoodQuality
ATCTGCCGTCATCCCT-1	GoodQuality
ATCTGCCGTGAGGGAG-1	GoodQuality
ATCTGCCTCAGGCAAG-1	GoodQuality
ATCTGCCTCCATTCTA-1	GoodQuality
ATGAGGGAGATCGATA-1	GoodQuality
ATGAGGGAGTCTCCTC-1	LowQuality
ATGAGGGGTACCGGCT-1	GoodQuality
ATGCGATAGACTAGAT-1	LowQuality
ATGCGATAGCAATCTC-1	GoodQuality
ATGCGATAGGTCATCT-1	GoodQuality
ATGCGATAGGTGCTTT-1	LowQuality
ATGCGATCAAGGACTG-1	LowQuality
ATGCGATCACGCTTTC-1	LowQuality
ATGCGATTCACTTCAT-1	GoodQuality
ATGCGATTCAGCCTAA-1	GoodQuality
ATGCGATTCTCTGAGA-1	GoodQuality
ATGCGATTCTGCCCTA-1	GoodQuality
ATGCGATTCTGTCCGT-1	LowQuality
ATGGGAGAGGTTCCTA-1	LowQuality
ATGGGAGAGTGTTTGC-1	GoodQuality
ATGGGAGCAAGGACAC-1	GoodQuality
ATGGGAGCAATGGACG-1	GoodQuality
ATGGGAGCACCAGGCT-1	GoodQuality
ATGGGAGCACGACGAA-1	GoodQuality
ATGGGAGCAGCCAGAA-1	GoodQuality
ATGGGAGCAGCCTATA-1	LowQuality
ATGGGAGCAGTTCCCT-1	GoodQuality
ATGGGAGGTGGCCCTA-1	GoodQuality
ATGGGAGTCTACTTAC-1	GoodQuality
ATGGGAGTCTTTACGT-1	GoodQuality
ATGTGTGCACACAGAG-1	GoodQuality
ATGTGTGCAGTAAGAT-1	GoodQuality
ATGTGTGGTTAGTGGG-1	GoodQuality
ATGTGTGTCATGTCTT-1	GoodQuality
ATGTGTGTCCAGATCA-1	LowQuality
ATTACTCAGTGACTCT-1	LowQuality
ATTACTCCATCACGTA-1	GoodQuality
ATTACTCCATGCCTAA-1	GoodQuality
ATTACTCGTCCGAAGA-1	LowQuality
ATTACTCGTCTGCGGT-1	GoodQuality
ATTACTCGTCTTTCAT-1	GoodQuality
ATTACTCGTGTTGGGA-1	GoodQuality
ATTACTCGTTAAAGAC-1	GoodQuality
ATTACTCGTTCTGGTA-1	LowQuality
ATTACTCGTTGGTGGA-1	GoodQuality
ATTACTCTCAAAGACA-1	GoodQuality
ATTACTCTCACCAGGC-1	GoodQuality
ATTACTCTCTGCGGCA-1	LowQuality
ATTATCCAGAACTGTA-1	GoodQuality
ATTATCCAGATATGCA-1	LowQuality
ATTATCCAGCAGGTCA-1	LowQuality
ATTATCCAGCGGCTTC-1	LowQuality
ATTATCCAGGGTGTGT-1	GoodQuality
ATTATCCGTACCGCTG-1	LowQuality
ATTATCCGTCCGAAGA-1	LowQuality
ATTATCCGTCCTCCAT-1	GoodQuality
ATTATCCTCACATACG-1	GoodQuality
ATTATCCTCGGGAGTA-1	LowQuality
ATTATCCTCTCAACTT-1	LowQuality
ATTCTACAGAGGTTAT-1	LowQuality
ATTCTACCACCTCGGA-1	GoodQuality
ATTCTACCACGCGAAA-1	GoodQuality
ATTCTACCACGGTTTA-1	GoodQuality
ATTCTACCATCGGGTC-1	LowQuality
ATTCTACCATGCCTTC-1	LowQuality
ATTCTACGTGTGGCTC-1	LowQuality
ATTCTACTCCTTCAAT-1	GoodQuality
ATTCTACTCTGCTGCT-1	GoodQuality
ATTGGACAGAGTCTGG-1	GoodQuality
ATTGGACAGCCACGCT-1	GoodQuality
ATTGGACAGCGTTGCC-1	GoodQuality
ATTGGACAGTACGTTC-1	GoodQuality
ATTGGACAGTGGTAAT-1	GoodQuality
ATTGGACCAAGAAGAG-1	GoodQuality
ATTGGACCAAGGTGTG-1	LowQuality
ATTGGACCAGGGCATA-1	GoodQuality
ATTGGACCATCGATTG-1	GoodQuality
ATTGGACGTCCAAGTT-1	GoodQuality
ATTGGACGTGCTGTAT-1	LowQuality
ATTGGACGTTCAACCA-1	GoodQuality
ATTGGACTCATAACCG-1	GoodQuality
ATTGGACTCGAGAGCA-1	GoodQuality
ATTGGACTCTGCGTAA-1	LowQuality
ATTGGACTCTGTCAAG-1	GoodQuality
ATTGGACTCTTGCATT-1	LowQuality
ATTGGTGAGTACGACG-1	GoodQuality
ATTGGTGAGTGGACGT-1	GoodQuality
ATTGGTGCACGGATAG-1	GoodQuality
ATTGGTGCAGTGACAG-1	GoodQuality
ATTGGTGCAGTTTACG-1	GoodQuality
ATTGGTGCATCACAAC-1	GoodQuality
ATTGGTGTCACCACCT-1	GoodQuality
ATTGGTGTCCGGGTGT-1	GoodQuality
ATTGGTGTCGCCAGCA-1	LowQuality
ATTGGTGTCTTACCGC-1	LowQuality
ATTTCTGAGCCATCGC-1	GoodQuality
ATTTCTGAGCTGGAAC-1	LowQuality
ATTTCTGAGGGCTTCC-1	LowQuality
ATTTCTGAGTGTACCT-1	GoodQuality
ATTTCTGCAAGAAGAG-1	LowQuality
ATTTCTGCAAGCCTAT-1	GoodQuality
ATTTCTGCACATGACT-1	GoodQuality
ATTTCTGCAGCATACT-1	LowQuality
ATTTCTGCAGCTCCGA-1	LowQuality
ATTTCTGCATCAGTCA-1	LowQuality
ATTTCTGGTACTTGAC-1	GoodQuality
ATTTCTGGTCGATTGT-1	LowQuality
ATTTCTGGTTCAACCA-1	GoodQuality
ATTTCTGTCGAGGTAG-1	GoodQuality
ATTTCTGTCGGCGCTA-1	GoodQuality
ATTTCTGTCTGTGCAA-1	GoodQuality
CAACCAAAGAACTGTA-1	GoodQuality
CAACCAAAGCATGGCA-1	LowQuality
CAACCAAAGGACGAAA-1	GoodQuality
CAACCAAAGGTAAACT-1	GoodQuality
CAACCAACACTATCTT-1	LowQuality
CAACCAACAGGAATCG-1	GoodQuality
CAACCAACATGAAGTA-1	GoodQuality
CAACCAACATGCCTAA-1	GoodQuality
CAACCAAGTACAGACG-1	GoodQuality
CAACCAAGTGTGACGA-1	GoodQuality
CAACCAAGTTATCCGA-1	GoodQuality
CAACCAATCCGCAGTG-1	GoodQuality
CAACCAATCTTACCTA-1	GoodQuality
CAACCAATCTTGCAAG-1	GoodQuality
CAACCTCAGCGCCTTG-1	GoodQuality
CAACCTCAGGACACCA-1	GoodQuality
CAACCTCCACCGAATT-1	GoodQuality
CAACCTCCAGCTGCAC-1	GoodQuality
CAACCTCGTCATATGC-1	GoodQuality
CAACCTCGTGATGCCC-1	GoodQuality
CAACCTCTCTTCCTTC-1	GoodQuality
CAACTAGAGCGCTTAT-1	LowQuality
CAACTAGAGGCTCTTA-1	LowQuality
CAACTAGAGTATCTCG-1	LowQuality
CAACTAGCAGCCTTTC-1	GoodQuality
CAACTAGCATTACGAC-1	GoodQuality
CAACTAGGTAGCTTGT-1	GoodQuality
CAACTAGGTCGACTAT-1	GoodQuality
CAACTAGGTCGAGATG-1	GoodQuality
CAACTAGGTGCCTGTG-1	LowQuality
CAACTAGTCTTCAACT-1	LowQuality
CAACTAGTCTTGCAAG-1	GoodQuality
CAAGAAAAGGAGTTGC-1	GoodQuality
CAAGAAAAGTCGTTTG-1	GoodQuality
CAAGAAACAAACTGTC-1	GoodQuality
CAAGAAACACTTACGA-1	GoodQuality
CAAGAAACAGCCTTGG-1	LowQuality
CAAGAAACAGGTCGTC-1	LowQuality
CAAGAAACATTCTCAT-1	GoodQuality
CAAGAAAGTAGAGCTG-1	LowQuality
CAAGAAAGTTCCACTC-1	LowQuality
CAAGAAAGTTGTCTTT-1	GoodQuality
CAAGAAATCCTCATTA-1	GoodQuality
CAAGAAATCTTCGAGA-1	GoodQuality
CAAGATCAGACTCGGA-1	LowQuality
CAAGATCAGCGGCTTC-1	GoodQuality
CAAGATCAGCTGAACG-1	LowQuality
CAAGATCAGTGATCGG-1	LowQuality
CAAGATCAGTGTTGAA-1	GoodQuality
CAAGATCAGTTGTCGT-1	GoodQuality
CAAGATCCACACCGAC-1	GoodQuality
CAAGATCGTAGTGAAT-1	GoodQuality
CAAGATCGTATTAGCC-1	GoodQuality
CAAGATCGTGTTGGGA-1	GoodQuality
CAAGATCGTTCGAATC-1	GoodQuality
CAAGATCGTTTGGGCC-1	GoodQuality
CAAGATCGTTTGTGTG-1	GoodQuality
CAAGATCTCAGGTAAA-1	GoodQuality
CAAGGCCAGGCGATAC-1	GoodQuality
CAAGGCCAGTTCGCGC-1	GoodQuality
CAAGGCCCAGTACACT-1	GoodQuality
CAAGGCCCAGTGGAGT-1	LowQuality
CAAGGCCGTACTCAAC-1	GoodQuality
CAAGGCCGTCCAGTTA-1	LowQuality
CAAGGCCGTCCGCTGA-1	LowQuality
CAAGGCCTCAAGCCTA-1	LowQuality
CAAGGCCTCTCTTATG-1	GoodQuality
CAAGTTGAGCCCTAAT-1	LowQuality
CAAGTTGGTCAATACC-1	GoodQuality
CAAGTTGGTGCAGACA-1	GoodQuality
CAAGTTGGTGTCTGAT-1	GoodQuality
CAAGTTGTCCAGATCA-1	LowQuality
CAAGTTGTCTAACTCT-1	GoodQuality
CACAAACAGAGTAATC-1	LowQuality
CACAAACAGATGTGGC-1	GoodQuality
CACAAACAGTGGTAGC-1	GoodQuality
CACAAACCATCATCCC-1	GoodQuality
CACAAACGTCCAGTAT-1	GoodQuality
CACAAACTCGGATGTT-1	GoodQuality
CACAAACTCGTGGTCG-1	GoodQuality
CACAAACTCTAACTCT-1	GoodQuality
CACACAAAGACATAAC-1	GoodQuality
CACACAAAGAGACGAA-1	GoodQuality
CACACAAAGGGTCGAT-1	LowQuality
CACACAACACATTTCT-1	LowQuality
CACACAACAGATCCAT-1	GoodQuality
CACACAACATATGAGA-1	GoodQuality
CACACAAGTACATCCA-1	GoodQuality
CACACAAGTAGGACAC-1	GoodQuality
CACACAAGTTCAGTAC-1	LowQuality
CACACCTAGATGGGTC-1	LowQuality
CACACCTCATCTCGCT-1	GoodQuality
CACACCTGTAACGACG-1	GoodQuality
CACACCTGTAGCTGCC-1	GoodQuality
CACACCTGTATCTGCA-1	GoodQuality
CACACCTGTCGCCATG-1	GoodQuality
CACACCTGTCGTTGTA-1	GoodQuality
CACACCTTCCAAGTAC-1	GoodQuality
CACACCTTCCGCATAA-1	LowQuality
CACACCTTCTCTTGAT-1	GoodQuality
CACACCTTCTTCAACT-1	GoodQuality
CACACTCCAGACAAGC-1	LowQuality
CACACTCCATTGAGCT-1	GoodQuality
CACACTCGTAAGGGAA-1	GoodQuality
CACACTCGTACCGCTG-1	GoodQuality
CACACTCGTAGCGCAA-1	LowQuality
CACACTCGTATAATGG-1	GoodQuality
CACACTCTCACTATTC-1	LowQuality
CACACTCTCCAGAAGG-1	GoodQuality
CACACTCTCGCCAGCA-1	LowQuality
CACACTCTCGGCGCTA-1	GoodQuality
CACAGGCAGCCCAATT-1	GoodQuality
CACAGGCAGCTAAGAT-1	LowQuality
CACAGGCAGTAATCCC-1	GoodQuality
CACAGGCAGTGCCAGA-1	GoodQuality
CACAGGCCAAGAAAGG-1	LowQuality
CACAGGCCATCACGTA-1	LowQuality
CACAGGCCATCGACGC-1	GoodQuality
CACAGGCGTGAGGGTT-1	LowQuality
CACAGGCTCATAAAGG-1	GoodQuality
CACAGGCTCGGTGTTA-1	GoodQuality
CACAGGCTCTCGTATT-1	GoodQuality
CACAGTAAGATCCGAG-1	LowQuality
CACAGTAAGCTGATAA-1	GoodQuality
CACAGTACAGCTCCGA-1	LowQuality
CACAGTAGTCGCTTCT-1	LowQuality
CACAGTAGTTCAGTAC-1	LowQuality
CACAGTATCGCCTGTT-1	GoodQuality
CACAGTATCTCTGAGA-1	LowQuality
CACATAGAGATGTAAC-1	GoodQuality
CACATAGAGGAGTTGC-1	GoodQuality
CACATAGAGGCTAGGT-1	LowQuality
CACATAGAGTAGCGGT-1	GoodQuality
CACATAGAGTGACATA-1	GoodQuality
CACATAGCAATCTACG-1	GoodQuality
CACATAGCACGTAAGG-1	GoodQuality
CACATAGCACTAAGTC-1	GoodQuality
CACATAGCATGCATGT-1	GoodQuality
CACATAGCATGCGCAC-1	LowQuality
CACATAGGTAAGTGTA-1	GoodQuality
CACATAGGTGGCTCCA-1	LowQuality
CACATAGGTTGTCGCG-1	LowQuality
CACATAGTCCGAACGC-1	GoodQuality
CACATAGTCTCTGAGA-1	LowQuality
CACATAGTCTTGAGGT-1	GoodQuality
CACATTTAGACAGGCT-1	GoodQuality
CACATTTAGAGGTAGA-1	GoodQuality
CACATTTAGGGCATGT-1	GoodQuality
CACATTTAGGGCTTCC-1	LowQuality
CACATTTCAATCTGCA-1	GoodQuality
CACATTTCAATGACCT-1	GoodQuality
CACATTTCAGTCACTA-1	GoodQuality
CACATTTCATGGTCAT-1	GoodQuality
CACATTTCATTGCGGC-1	LowQuality
CACATTTGTAAAGGAG-1	GoodQuality
CACATTTGTATAGTAG-1	GoodQuality
CACATTTGTCTAGCCG-1	GoodQuality
CACATTTTCGCCATAA-1	LowQuality
CACATTTTCGCGGATC-1	GoodQuality
CACCACTAGATATACG-1	GoodQuality
CACCACTAGGCTAGCA-1	GoodQuality
CACCACTAGTGCGATG-1	GoodQuality
CACCACTCAACCGCCA-1	GoodQuality
CACCACTCAAGTCATC-1	GoodQuality
CACCACTCAGCGTCCA-1	LowQuality
CACCACTCATCGATGT-1	GoodQuality
CACCACTCATGATCCA-1	LowQuality
CACCACTCATTAGCCA-1	GoodQuality
CACCACTGTTACGCGC-1	GoodQuality
CACCACTTCACGCATA-1	GoodQuality
CACCACTTCAGTTAGC-1	GoodQuality
CACCACTTCCAAGCCG-1	GoodQuality
CACCACTTCCCATTAT-1	GoodQuality
CACCAGGAGTAGGCCA-1	LowQuality
CACCAGGAGTTACCCA-1	GoodQuality
CACCAGGCACCGTTGG-1	GoodQuality
CACCAGGCAGATGGCA-1	LowQuality
CACCAGGCATCACCCT-1	GoodQuality
CACCAGGCATGCTGGC-1	LowQuality
CACCAGGGTCAAAGAT-1	GoodQuality
CACCAGGTCAAGGCTT-1	GoodQuality
CACCTTGAGGGATGGG-1	GoodQuality
CACCTTGCAGATCCAT-1	GoodQuality
CACCTTGCAGGGTTAG-1	GoodQuality
CACCTTGCATGAAGTA-1	GoodQuality
CACCTTGGTCATGCCG-1	LowQuality
CACCTTGTCAAACCAC-1	GoodQuality
CACCTTGTCACCACCT-1	LowQuality
CACCTTGTCAGAAATG-1	GoodQuality
CACCTTGTCCATTCTA-1	LowQuality
CACCTTGTCGATAGAA-1	LowQuality
CACTCCAAGTCTCGGC-1	GoodQuality
CACTCCACAATCCGAT-1	GoodQuality
CACTCCACACACCGAC-1	GoodQuality
CACTCCACAGCTGCTG-1	GoodQuality
CACTCCACAGGGCATA-1	GoodQuality
CACTCCAGTAAGGGAA-1	LowQuality
CACTCCAGTACCATCA-1	GoodQuality
CACTCCAGTAGGCATG-1	GoodQuality
CACTCCAGTGCCTTGG-1	GoodQuality
CACTCCAGTTACCGAT-1	GoodQuality
CACTCCAGTTCCATGA-1	LowQuality
CACTCCATCAGTTCGA-1	GoodQuality
CACTCCATCTTCAACT-1	LowQuality
CAGAATCAGCGTTTAC-1	GoodQuality
CAGAATCCAAAGTGCG-1	LowQuality
CAGAATCCAACCGCCA-1	GoodQuality
CAGAATCCATTCACTT-1	GoodQuality
CAGAATCTCCCTGACT-1	GoodQuality
CAGAATCTCGCATGGC-1	GoodQuality
CAGAATCTCTAACTGG-1	GoodQuality
CAGAGAGAGAACTGTA-1	GoodQuality
CAGAGAGAGATGTGTA-1	GoodQuality
CAGAGAGCACTAAGTC-1	LowQuality
CAGAGAGCATCTCCCA-1	GoodQuality
CAGAGAGGTCGTTGTA-1	GoodQuality
CAGAGAGTCGGTTAAC-1	GoodQuality
CAGATCAAGCCATCGC-1	GoodQuality
CAGATCACAGCCTTGG-1	GoodQuality
CAGATCACAGCTGTAT-1	LowQuality
CAGATCAGTGAACCTT-1	GoodQuality
CAGATCAGTGGTTTCA-1	GoodQuality
CAGATCATCAACGGGA-1	GoodQuality
CAGATCATCATCGATG-1	GoodQuality
CAGCAGCAGCTGTCTA-1	LowQuality
CAGCAGCAGTCCTCCT-1	GoodQuality
CAGCAGCAGTGTTTGC-1	GoodQuality
CAGCAGCCATTGGTAC-1	GoodQuality
CAGCAGCGTAAATGTG-1	GoodQuality
CAGCAGCGTACCAGTT-1	GoodQuality
CAGCAGCGTTTAGCTG-1	LowQuality
CAGCAGCTCGTCTGCT-1	GoodQuality
CAGCATAAGACGACGT-1	GoodQuality
CAGCATAAGCAATATG-1	LowQuality
CAGCATAAGGCAAAGA-1	GoodQuality
CAGCATACAAGCCGTC-1	LowQuality
CAGCATACAATCGGTT-1	LowQuality
CAGCATACACAGTCGC-1	GoodQuality
CAGCATACAGAGCCAA-1	GoodQuality
CAGCATACATGCTGGC-1	GoodQuality
CAGCATACATTTCAGG-1	LowQuality
CAGCATAGTTAAGACA-1	GoodQuality
CAGCATAGTTCGCTAA-1	GoodQuality
CAGCATATCAAGATCC-1	GoodQuality
CAGCATATCGGTCCGA-1	GoodQuality
CAGCCGAAGAAACCGC-1	GoodQuality
CAGCCGACATCGGACC-1	GoodQuality
CAGCCGACATGTAAGA-1	GoodQuality
CAGCCGAGTAGAGTGC-1	GoodQuality
CAGCCGAGTCGCGGTT-1	GoodQuality
CAGCCGATCAGAGACG-1	GoodQuality
CAGCCGATCTCGTTTA-1	GoodQuality
CAGCCGATCTTCGGTC-1	GoodQuality
CAGCCGATCTTGTACT-1	GoodQuality
CAGCGACAGGCTACGA-1	GoodQuality
CAGCGACAGGTAGCTG-1	GoodQuality
CAGCGACCAATGGTCT-1	GoodQuality
CAGCGACCACACAGAG-1	GoodQuality
CAGCGACGTATATGGA-1	GoodQuality
CAGCGACGTGGACGAT-1	GoodQuality
CAGCGACTCATCATTC-1	GoodQuality
CAGCGACTCTAACGGT-1	GoodQuality
CAGCTAAAGGACCACA-1	GoodQuality
CAGCTAAAGTGTCCAT-1	LowQuality
CAGCTAACAATGGACG-1	GoodQuality
CAGCTAACACAACGCC-1	LowQuality
CAGCTAACACTGCCAG-1	GoodQuality
CAGCTAAGTGTCCTCT-1	GoodQuality
CAGCTAAGTTGGACCC-1	GoodQuality
CAGCTAATCACGATGT-1	GoodQuality
CAGCTAATCAGCGATT-1	LowQuality
CAGCTGGAGACAGGCT-1	LowQuality
CAGCTGGAGCTCCCAG-1	GoodQuality
CAGCTGGAGTACGATA-1	GoodQuality
CAGCTGGCAAGCTGTT-1	LowQuality
CAGCTGGGTGATGCCC-1	LowQuality
CAGCTGGGTTGTGGCC-1	LowQuality
CAGCTGGTCATGTCCC-1	GoodQuality
CAGCTGGTCCACGACG-1	LowQuality
CAGCTGGTCCCTCAGT-1	GoodQuality
CAGCTGGTCGTCCAGG-1	GoodQuality
CAGCTGGTCTAACTTC-1	GoodQuality
CAGGTGCAGATGGCGT-1	LowQuality
CAGGTGCAGATGTCGG-1	GoodQuality
CAGGTGCAGCTACCGC-1	LowQuality
CAGGTGCAGGCAGGTT-1	GoodQuality
CAGGTGCAGTTGCAGG-1	GoodQuality
CAGGTGCCAAAGCGGT-1	GoodQuality
CAGGTGCCAAGCTGTT-1	GoodQuality
CAGGTGCCAGATAATG-1	GoodQuality
CAGGTGCCATCGGTTA-1	GoodQuality
CAGGTGCCATGCTGGC-1	GoodQuality
CAGGTGCCATTAACCG-1	GoodQuality
CAGGTGCGTCTTGATG-1	LowQuality
CAGGTGCTCCCGACTT-1	LowQuality
CAGGTGCTCGTTACAG-1	LowQuality
CAGTAACAGATGTTAG-1	GoodQuality
CAGTAACCACGGTGTC-1	GoodQuality
CAGTAACCACTGTCGG-1	GoodQuality
CAGTAACGTAGAGGAA-1	GoodQuality
CAGTAACGTCTGCAAT-1	GoodQuality
CAGTAACGTGACGCCT-1	LowQuality
CAGTAACGTGCACCAC-1	GoodQuality
CAGTAACTCCGTCAAA-1	GoodQuality
CAGTCCTAGAAACCAT-1	GoodQuality
CAGTCCTAGAATGTGT-1	GoodQuality
CAGTCCTAGAGAACAG-1	GoodQuality
CAGTCCTCAAGCGCTC-1	GoodQuality
CAGTCCTGTAGCAAAT-1	GoodQuality
CAGTCCTGTCAGATAA-1	GoodQuality
CAGTCCTGTGTTCTTT-1	GoodQuality
CAGTCCTTCACTATTC-1	GoodQuality
CAGTCCTTCGACAGCC-1	LowQuality
CAGTCCTTCGCGGATC-1	GoodQuality
CAGTCCTTCTGCGGCA-1	GoodQuality
CATATGGAGACAGAGA-1	GoodQuality
CATATGGCAAGCTGTT-1	GoodQuality
CATATGGCATCCTTGC-1	LowQuality
CATATGGGTCTAACGT-1	GoodQuality
CATATGGGTGTGAATA-1	GoodQuality
CATATGGTCAGCTCTC-1	LowQuality
CATATGGTCGTGGGAA-1	LowQuality
CATATGGTCTTACCGC-1	GoodQuality
CATATTCAGACAAGCC-1	GoodQuality
CATATTCCATATGGTC-1	GoodQuality
CATATTCCATCCCATC-1	LowQuality
CATATTCCATCCTTGC-1	GoodQuality
CATATTCCATGTCCTC-1	LowQuality
CATATTCCATTACGAC-1	GoodQuality
CATATTCGTAAGAGAG-1	GoodQuality
CATATTCGTGTGTGCC-1	GoodQuality
CATATTCGTTAGTGGG-1	GoodQuality
CATATTCTCCACGACG-1	LowQuality
CATATTCTCCTGCTTG-1	GoodQuality
CATCAAGAGGAGTCTG-1	GoodQuality
CATCAAGAGGCCCTCA-1	GoodQuality
CATCAAGAGTCAAGCG-1	GoodQuality
CATCAAGAGTTCGCGC-1	GoodQuality
CATCAAGCACATTTCT-1	GoodQuality
CATCAAGCACCACGTG-1	GoodQuality
CATCAAGCATTGTGCA-1	GoodQuality
CATCAAGGTAAGGGAA-1	LowQuality
CATCAAGGTACCGAGA-1	GoodQuality
CATCAAGGTGAGGGAG-1	GoodQuality
CATCAAGTCCACTCCA-1	GoodQuality
CATCAAGTCTACTTAC-1	GoodQuality
CATCAAGTCTTGCATT-1	GoodQuality
CATCAGACAAGGTTTC-1	GoodQuality
CATCAGACAATGCCAT-1	LowQuality
CATCAGACACTGCCAG-1	LowQuality
CATCAGACATCATCCC-1	LowQuality
CATCAGAGTAAATGTG-1	GoodQuality
CATCAGATCAGAGGTG-1	LowQuality
CATCAGATCATCACCC-1	GoodQuality
CATCAGATCATGCTCC-1	GoodQuality
CATCAGATCTCTAAGG-1	LowQuality
CATCAGATCTTGCAAG-1	GoodQuality
CATCCACAGAAGGTGA-1	LowQuality
CATCCACAGACTTTCG-1	GoodQuality
CATCCACAGGTAGCTG-1	LowQuality
CATCCACAGTGGAGTC-1	LowQuality
CATCCACCACATGTGT-1	GoodQuality
CATCCACCATTCCTCG-1	GoodQuality
CATCCACGTCGAGATG-1	LowQuality
CATCCACGTGCTTCTC-1	GoodQuality
CATCCACGTTCCACGG-1	GoodQuality
CATCCACTCCACGTTC-1	GoodQuality
CATCCACTCCCACTTG-1	GoodQuality
CATCCACTCTACTATC-1	LowQuality
CATCGAAAGAAGGTGA-1	GoodQuality
CATCGAAAGATATGCA-1	GoodQuality
CATCGAAAGGTGCACA-1	GoodQuality
CATCGAAAGGTTCCTA-1	GoodQuality
CATCGAACACAGAGGT-1	GoodQuality
CATCGAACACATTAGC-1	LowQuality
CATCGAACATGCTGGC-1	GoodQuality
CATCGAATCTATCCTA-1	LowQuality
CATCGGGGTGCAACGA-1	GoodQuality
CATCGGGTCTTGTCAT-1	LowQuality
CATGACAAGATCACGG-1	LowQuality
CATGACAAGTGTACTC-1	GoodQuality
CATGACACACCAGGCT-1	GoodQuality
CATGACACAGCATGAG-1	GoodQuality
CATGACACAGTATGCT-1	LowQuality
CATGACAGTAGCGCTC-1	LowQuality
CATGACAGTCCGCTGA-1	LowQuality
CATGACAGTCGCTTTC-1	GoodQuality
CATGACAGTCTTTCAT-1	GoodQuality
CATGACAGTTCCACGG-1	GoodQuality
CATGACATCACGAAGG-1	GoodQuality
CATGACATCGCTTGTC-1	GoodQuality
CATGCCTAGACATAAC-1	LowQuality
CATGCCTAGTGTACCT-1	LowQuality
CATGCCTCAAAGTCAA-1	GoodQuality
CATGCCTCAGCTGCAC-1	GoodQuality
CATGCCTCATGCCCGA-1	GoodQuality
CATGCCTGTCACCCAG-1	LowQuality
CATGCCTTCACGCGGT-1	LowQuality
CATGCCTTCATGCATG-1	GoodQuality
CATGCCTTCCAGGGCT-1	GoodQuality
CATGCCTTCTCCGGTT-1	GoodQuality
CATGGCGAGAAACCAT-1	LowQuality
CATGGCGAGAGCTTCT-1	GoodQuality
CATGGCGAGCCGGTAA-1	GoodQuality
CATGGCGAGGAATGGA-1	GoodQuality
CATGGCGCAAACCCAT-1	LowQuality
CATGGCGCAAGGTGTG-1	GoodQuality
CATGGCGCACACTGCG-1	GoodQuality
CATGGCGCACCAGTTA-1	GoodQuality
CATGGCGCATATGGTC-1	LowQuality
CATGGCGCATGGGAAC-1	GoodQuality
CATGGCGCATTACGAC-1	GoodQuality
CATGGCGGTCAACTGT-1	GoodQuality
CATGGCGGTTAAGATG-1	GoodQuality
CATGGCGGTTACGTCA-1	GoodQuality
CATGGCGGTTTGACAC-1	GoodQuality
CATGGCGTCAAAGACA-1	GoodQuality
CATGGCGTCACCCTCA-1	GoodQuality
CATTATCAGTACGCGA-1	GoodQuality
CATTATCAGTCCGTAT-1	LowQuality
CATTATCCAACACGCC-1	GoodQuality
CATTATCCACCTCGGA-1	LowQuality
CATTATCGTACCGTTA-1	GoodQuality
CATTATCGTTGTCGCG-1	GoodQuality
CATTATCTCGGCATCG-1	LowQuality
CATTCGCAGACTCGGA-1	GoodQuality
CATTCGCAGCTAACTC-1	LowQuality
CATTCGCAGGCTATCT-1	GoodQuality
CATTCGCCAAGCTGGA-1	GoodQuality
CATTCGCCACATGGGA-1	GoodQuality
CATTCGCCACTTCGAA-1	LowQuality
CATTCGCCATGAGCGA-1	GoodQuality
CATTCGCGTAGTGAAT-1	LowQuality
CATTCGCGTCTACCTC-1	GoodQuality
CATTCGCGTCTGATTG-1	LowQuality
CATTCGCTCCATGAAC-1	GoodQuality
CATTCGCTCCTTTCTC-1	LowQuality
CATTCGCTCGAATGGG-1	GoodQuality
CATTCGCTCTATCGCC-1	GoodQuality
CCAATCCAGCGATATA-1	LowQuality
CCAATCCAGGCTCAGA-1	LowQuality
CCAATCCAGTGTACCT-1	LowQuality
CCAATCCAGTGTTTGC-1	LowQuality
CCAATCCCAAATCCGT-1	GoodQuality
CCAATCCCATGAACCT-1	LowQuality
CCAATCCGTAGGCATG-1	LowQuality
CCAATCCGTAGGGTAC-1	GoodQuality
CCAATCCGTCCGAATT-1	GoodQuality
CCAATCCGTCTAACGT-1	LowQuality
CCAATCCTCACCGTAA-1	GoodQuality
CCAATCCTCAGCAACT-1	GoodQuality
CCACCTAAGCCGGTAA-1	GoodQuality
CCACCTAAGCGACGTA-1	GoodQuality
CCACCTAAGCGATGAC-1	GoodQuality
CCACCTACACATGTGT-1	GoodQuality
CCACCTAGTACATCCA-1	LowQuality
CCACCTAGTACGCACC-1	GoodQuality
CCACCTAGTTCTGAAC-1	GoodQuality
CCACCTAGTTGGTTTG-1	LowQuality
CCACCTAGTTTCCACC-1	LowQuality
CCACCTATCGGCTACG-1	LowQuality
CCACCTATCTGCTGCT-1	GoodQuality
CCACGGAAGATGTCGG-1	GoodQuality
CCACGGAAGCACCGTC-1	LowQuality
CCACGGAAGTACGATA-1	LowQuality
CCACGGACAGATCTGT-1	GoodQuality
CCACGGACATGTCGAT-1	GoodQuality
CCACGGATCGCTAGCG-1	GoodQuality
CCACGGATCTAACGGT-1	LowQuality
CCACGGATCTCGAGTA-1	LowQuality
CCACTACAGTACTTGC-1	GoodQuality
CCACTACCAAGGTTCT-1	GoodQuality
CCACTACCACAAGACG-1	GoodQuality
CCACTACCACAGATTC-1	GoodQuality
CCACTACCACATCCAA-1	LowQuality
CCACTACCACGAAATA-1	GoodQuality
CCACTACGTATAAACG-1	GoodQuality
CCACTACGTCGAACAG-1	GoodQuality
CCACTACGTGTATGGG-1	LowQuality
CCACTACTCTTGACGA-1	LowQuality
CCAGCGAAGACTAAGT-1	GoodQuality
CCAGCGAAGTGAACGC-1	GoodQuality
CCAGCGACACGCCAGT-1	GoodQuality
CCAGCGACAGACAGGT-1	LowQuality
CCAGCGAGTGCTTCTC-1	GoodQuality
CCAGCGATCATTATCC-1	GoodQuality
CCAGCGATCCACTCCA-1	GoodQuality
CCAGCGATCTGCCCTA-1	GoodQuality
CCATGTCAGTAAGTAC-1	GoodQuality
CCATGTCAGTACACCT-1	LowQuality
CCATGTCCATAAGACA-1	GoodQuality
CCATGTCGTACAGTGG-1	GoodQuality
CCATGTCGTACGAAAT-1	GoodQuality
CCATGTCTCAATCACG-1	GoodQuality
CCATGTCTCATCGATG-1	GoodQuality
CCATGTCTCATGCTCC-1	GoodQuality
CCATGTCTCCAAAGTC-1	LowQuality
CCATTCGAGAGCTGGT-1	LowQuality
CCATTCGAGCCACGCT-1	GoodQuality
CCATTCGCATGCCACG-1	GoodQuality
CCATTCGTCAGTTGAC-1	LowQuality
CCATTCGTCATCGATG-1	GoodQuality
CCATTCGTCGCGCCAA-1	GoodQuality
CCATTCGTCGGATGTT-1	GoodQuality
CCCAATCAGAAGAAGC-1	GoodQuality
CCCAATCAGAGTACCG-1	LowQuality
CCCAATCAGCTAGTCT-1	LowQuality
CCCAATCCACGACTCG-1	GoodQuality
CCCAATCCAGGGCATA-1	GoodQuality
CCCAATCGTGGCAAAC-1	GoodQuality
CCCAATCGTGTGGCTC-1	GoodQuality
CCCAATCTCCGGGTGT-1	GoodQuality
CCCAATCTCGGAATCT-1	LowQuality
CCCAGTTCACGACGAA-1	LowQuality
CCCAGTTCAGATAATG-1	GoodQuality
CCCAGTTCATACTCTT-1	LowQuality
CCCAGTTCATGCAACT-1	GoodQuality
CCCAGTTCATTATCTC-1	LowQuality
CCCAGTTGTACTTGAC-1	GoodQuality
CCCAGTTGTTCCACTC-1	GoodQuality
CCCAGTTTCATTCACT-1	GoodQuality
CCCAGTTTCCATGAGT-1	GoodQuality
CCCATACAGAAGAAGC-1	GoodQuality
CCCATACAGAGGTACC-1	GoodQuality
CCCATACCACCAGCAC-1	LowQuality
CCCATACCACGGCTAC-1	GoodQuality
CCCATACGTCCTAGCG-1	GoodQuality
CCCATACGTTCGTCTC-1	LowQuality
CCCTCCTAGTATGACA-1	LowQuality
CCCTCCTCAGTATAAG-1	LowQuality
CCCTCCTGTAGAGCTG-1	LowQuality
CCCTCCTGTAGGAGTC-1	GoodQuality
CCCTCCTGTCGACTAT-1	GoodQuality
CCCTCCTGTTGCGTTA-1	GoodQuality
CCCTCCTTCCAGGGCT-1	LowQuality
CCCTCCTTCCCTCTTT-1	GoodQuality
CCCTCCTTCCTAAGTG-1	GoodQuality
CCGGGATAGATCCCGC-1	GoodQuality
CCGGGATAGCTAAGAT-1	LowQuality
CCGGGATAGGATATAC-1	LowQuality
CCGGGATCAAGCGATG-1	GoodQuality
CCGGGATCACGACTCG-1	GoodQuality
CCGGGATCAGCCAATT-1	GoodQuality
CCGGGATCATTCGACA-1	LowQuality
CCGGGATGTAGGGTAC-1	LowQuality
CCGGGATGTGGCCCTA-1	GoodQuality
CCGGGATTCACCCTCA-1	GoodQuality
CCGGGATTCACTGGGC-1	GoodQuality
CCGGGATTCCTCCTAG-1	GoodQuality
CCGGTAGAGACTAGAT-1	GoodQuality
CCGGTAGAGATAGCAT-1	GoodQuality
CCGGTAGAGGCATGGT-1	GoodQuality
CCGGTAGAGGGAACGG-1	LowQuality
CCGGTAGAGTCAATAG-1	GoodQuality
CCGGTAGAGTGCGTGA-1	GoodQuality
CCGGTAGCAACACGCC-1	LowQuality
CCGGTAGCAACCGCCA-1	GoodQuality
CCGGTAGCAAGTCTGT-1	LowQuality
CCGGTAGCACCGAAAG-1	GoodQuality
CCGGTAGCACCGAATT-1	GoodQuality
CCGGTAGCAGTAGAGC-1	GoodQuality
CCGGTAGGTCAGAGGT-1	LowQuality
CCGGTAGGTGATGTCT-1	GoodQuality
CCGGTAGGTTATTCTC-1	LowQuality
CCGGTAGGTTGGACCC-1	GoodQuality
CCGGTAGTCACTTCAT-1	LowQuality
CCGGTAGTCCTTTCTC-1	LowQuality
CCGTACTAGACGACGT-1	LowQuality
CCGTACTAGGATCGCA-1	GoodQuality
CCGTACTAGGCTAGGT-1	LowQuality
CCGTACTGTATCAGTC-1	LowQuality
CCGTACTGTTTGCATG-1	GoodQuality
CCGTACTTCGCCGTGA-1	GoodQuality
CCGTACTTCTTGCAAG-1	GoodQuality
CCGTGGAAGAGAGCTC-1	GoodQuality
CCGTGGACAGGTCGTC-1	LowQuality
CCGTGGAGTCACCTAA-1	GoodQuality
CCGTGGAGTTCAGTAC-1	GoodQuality
CCGTGGAGTTCCTCCA-1	GoodQuality
CCGTGGATCAAGATCC-1	GoodQuality
CCGTGGATCACATGCA-1	GoodQuality
CCGTGGATCGCAAACT-1	GoodQuality
CCGTGGATCTCGTATT-1	GoodQuality
CCGTTCAAGAGGTACC-1	GoodQuality
CCGTTCAAGAGTGAGA-1	GoodQuality
CCGTTCAAGCAGGCTA-1	GoodQuality
CCGTTCAAGCGAGAAA-1	GoodQuality
CCGTTCACACATCTTT-1	LowQuality
CCGTTCACAGCTGCAC-1	GoodQuality
CCGTTCACAGGTGGAT-1	GoodQuality
CCGTTCACATTCTTAC-1	GoodQuality
CCGTTCAGTACATGTC-1	GoodQuality
CCGTTCAGTCCCGACA-1	LowQuality
CCGTTCAGTGTCAATC-1	GoodQuality
CCGTTCAGTTGGGACA-1	LowQuality
CCGTTCATCTTATCTG-1	GoodQuality
CCTAAAGAGAGGACGG-1	GoodQuality
CCTAAAGCACAGATTC-1	LowQuality
CCTAAAGCAGCCACCA-1	GoodQuality
CCTAAAGCATGCAACT-1	GoodQuality
CCTAAAGCATTAGCCA-1	LowQuality
CCTAAAGGTTTAGCTG-1	GoodQuality
CCTAAAGTCATGTCTT-1	LowQuality
CCTACACAGAAAGTGG-1	LowQuality
CCTACACAGAACAACT-1	LowQuality
CCTACACAGGTGTGGT-1	GoodQuality
CCTACACCAGATAATG-1	GoodQuality
CCTACACCAGTCTTCC-1	GoodQuality
CCTACACCATGCCCGA-1	GoodQuality
CCTACACGTCTCTCTG-1	GoodQuality
CCTACACTCAACGGGA-1	GoodQuality
CCTACACTCATCTGTT-1	GoodQuality
CCTACACTCCTTTCTC-1	LowQuality
CCTACACTCGCGATCG-1	GoodQuality
CCTACCAAGATCGGGT-1	GoodQuality
CCTACCAAGCGAAGGG-1	GoodQuality
CCTACCAAGTCTCCTC-1	GoodQuality
CCTACCACAAACGTGG-1	GoodQuality
CCTACCACACCGAAAG-1	GoodQuality
CCTACCACAGACTCGC-1	GoodQuality
CCTACCACAGTGACAG-1	GoodQuality
CCTACCACATGCAACT-1	GoodQuality
CCTACCAGTAAAGTCA-1	GoodQuality
CCTACCAGTATATGAG-1	GoodQuality
CCTACCAGTCATATCG-1	GoodQuality
CCTACCAGTGATAAGT-1	GoodQuality
CCTACCAGTGTCGCTG-1	GoodQuality
CCTACCAGTGTTGGGA-1	LowQuality
CCTACCAGTTTGGGCC-1	GoodQuality
CCTACCATCGCCCTTA-1	LowQuality
CCTAGCTAGACCTAGG-1	LowQuality
CCTAGCTAGCCGTCGT-1	GoodQuality
CCTAGCTCAATTGCTG-1	GoodQuality
CCTAGCTCACAACGTT-1	GoodQuality
CCTAGCTCAGTCACTA-1	LowQuality
CCTAGCTCATGCAATC-1	GoodQuality
CCTAGCTGTACCGAGA-1	LowQuality
CCTAGCTTCAGAGCTT-1	GoodQuality
CCTATTAAGAACAATC-1	GoodQuality
CCTATTAAGCCGCCTA-1	GoodQuality
CCTATTAAGGACACCA-1	LowQuality
CCTATTACACCTATCC-1	GoodQuality
CCTATTAGTCCAGTTA-1	GoodQuality
CCTATTAGTGACCAAG-1	LowQuality
CCTATTATCCTTCAAT-1	LowQuality
CCTATTATCTCCAACC-1	GoodQuality
CCTCAGTCAAAGGAAG-1	GoodQuality
CCTCAGTCAGGTCGTC-1	GoodQuality
CCTCAGTCATCCCATC-1	GoodQuality
CCTCAGTCATTAGCCA-1	LowQuality
CCTCAGTTCAAGAAGT-1	LowQuality
CCTCTGAAGCCAACAG-1	GoodQuality
CCTCTGAAGGGAGTAA-1	GoodQuality
CCTCTGACACGAAAGC-1	GoodQuality
CCTCTGACACGCTTTC-1	GoodQuality
CCTCTGACAGTACACT-1	GoodQuality
CCTCTGAGTAAACGCG-1	GoodQuality
CCTCTGAGTACATGTC-1	GoodQuality
CCTCTGAGTATGGTTC-1	GoodQuality
CCTCTGAGTCTAGGTT-1	GoodQuality
CCTCTGAGTTGCCTCT-1	GoodQuality
CCTCTGATCAACGGCC-1	GoodQuality
CCTCTGATCAGGTAAA-1	GoodQuality
CCTCTGATCCAAAGTC-1	GoodQuality
CCTCTGATCCTGTACC-1	LowQuality
CCTCTGATCGTTGCCT-1	LowQuality
CCTCTGATCTGGAGCC-1	LowQuality
CCTCTGATCTTTACGT-1	GoodQuality
CCTTACGAGAAGAAGC-1	GoodQuality
CCTTACGAGCGCCTCA-1	GoodQuality
CCTTACGAGGGATGGG-1	GoodQuality
CCTTACGCAACCGCCA-1	LowQuality
CCTTACGCAAGCCGCT-1	LowQuality
CCTTACGCACAGATTC-1	LowQuality
CCTTACGCACCAACCG-1	GoodQuality
CCTTACGCATCGGGTC-1	GoodQuality
CCTTACGCATTATCTC-1	GoodQuality
CCTTACGGTCCGCTGA-1	GoodQuality
CCTTACGGTTCACCTC-1	GoodQuality
CCTTACGTCACCAGGC-1	GoodQuality
CCTTCCCAGAAACCGC-1	GoodQuality
CCTTCCCAGCATCATC-1	GoodQuality
CCTTCCCAGCCAACAG-1	GoodQuality
CCTTCCCAGTGGTCCC-1	GoodQuality
CCTTCCCAGTTATCGC-1	GoodQuality
CCTTCCCCAACTTGAC-1	GoodQuality
CCTTCCCGTGAGGCTA-1	GoodQuality
CCTTCCCGTTCCAACA-1	GoodQuality
CCTTCCCTCCTGTAGA-1	GoodQuality
CCTTCCCTCTAGCACA-1	GoodQuality
CCTTCCCTCTCAAGTG-1	GoodQuality
CCTTCGAAGACCTAGG-1	GoodQuality
CCTTCGAAGCTGAAAT-1	GoodQuality
CCTTCGAAGGCATGTG-1	GoodQuality
CCTTCGAAGTACGACG-1	GoodQuality
CCTTCGACAATCTACG-1	GoodQuality
CCTTCGACACCTCGGA-1	GoodQuality
CCTTCGACACGGCCAT-1	LowQuality
CCTTCGACACGGTGTC-1	GoodQuality
CCTTCGACAGTCACTA-1	GoodQuality
CCTTCGAGTCAAAGAT-1	GoodQuality
CCTTCGAGTGAGTATA-1	GoodQuality
CCTTCGATCATCTGCC-1	GoodQuality
CCTTCGATCCTCAATT-1	GoodQuality
CCTTCGATCGACGGAA-1	GoodQuality
CCTTCGATCTGTTTGT-1	GoodQuality
CCTTTCTAGGGAAACA-1	LowQuality
CCTTTCTCAGGAACGT-1	GoodQuality
CCTTTCTCAGGAATGC-1	LowQuality
CCTTTCTGTAAGGGAA-1	LowQuality
CCTTTCTGTTCCAACA-1	LowQuality
CCTTTCTTCACCCGAG-1	GoodQuality
CCTTTCTTCCGAACGC-1	GoodQuality
CCTTTCTTCTTACCGC-1	LowQuality
CCTTTCTTCTTGAGGT-1	GoodQuality
CGAACATAGCCCAACC-1	GoodQuality
CGAACATAGCTCCCAG-1	GoodQuality
CGAACATAGGACAGAA-1	GoodQuality
CGAACATCACTAGTAC-1	GoodQuality
CGAACATCAGGAATGC-1	GoodQuality
CGAACATCAGGACGTA-1	LowQuality
CGAACATGTACCCAAT-1	GoodQuality
CGAACATGTAGAGCTG-1	GoodQuality
CGAACATGTATAGTAG-1	GoodQuality
CGAACATGTGACAAAT-1	GoodQuality
CGAACATGTTTAGGAA-1	GoodQuality
CGAACATTCACGCATA-1	LowQuality
CGAACATTCGCCAAAT-1	LowQuality
CGAACATTCTAACTGG-1	GoodQuality
CGAATGTAGCTCCTTC-1	GoodQuality
CGAATGTCAAAGCGGT-1	LowQuality
CGAATGTCACAGAGGT-1	GoodQuality
CGAATGTCACCAGATT-1	GoodQuality
CGAATGTCACCAGGTC-1	GoodQuality
CGAATGTCACCTGGTG-1	GoodQuality
CGAATGTCACGTCTCT-1	GoodQuality
CGAATGTCAGCGAACA-1	LowQuality
CGAATGTCAGGTCTCG-1	GoodQuality
CGAATGTCATTGGCGC-1	LowQuality
CGAATGTGTAGAGCTG-1	GoodQuality
CGAATGTGTCAACATC-1	GoodQuality
CGAATGTTCACTATTC-1	GoodQuality
CGAATGTTCATGTAGC-1	GoodQuality
CGAATGTTCCGCATCT-1	LowQuality
CGAATGTTCGGTGTTA-1	GoodQuality
CGAATGTTCTCGTATT-1	GoodQuality
CGAATGTTCTTACCTA-1	GoodQuality
CGAATGTTCTTGTACT-1	GoodQuality
CGACCTTAGCACCGCT-1	GoodQuality
CGACCTTAGCGTTCCG-1	LowQuality
CGACCTTGTCGCGTGT-1	GoodQuality
CGACCTTGTGTCCTCT-1	GoodQuality
CGACCTTTCATAAAGG-1	LowQuality
CGACCTTTCGGACAAG-1	GoodQuality
CGACTTCAGATCCCAT-1	GoodQuality
CGACTTCAGCCACTAT-1	GoodQuality
CGACTTCAGGCTAGGT-1	GoodQuality
CGACTTCGTGTGAATA-1	GoodQuality
CGACTTCGTTCACGGC-1	LowQuality
CGACTTCGTTGGTAAA-1	GoodQuality
CGACTTCTCCCTCAGT-1	GoodQuality
CGACTTCTCGCCATAA-1	GoodQuality
CGAGAAGAGAATTGTG-1	LowQuality
CGAGAAGAGATAGGAG-1	LowQuality
CGAGAAGAGCTAGGCA-1	GoodQuality
CGAGAAGAGTCAAGCG-1	GoodQuality
CGAGAAGAGTCTCCTC-1	GoodQuality
CGAGAAGCAAGCGATG-1	GoodQuality
CGAGAAGCAGATCTGT-1	GoodQuality
CGAGAAGCAGGGTACA-1	GoodQuality
CGAGAAGCATGCGCAC-1	LowQuality
CGAGAAGGTCCGAATT-1	GoodQuality
CGAGAAGGTCCTCCAT-1	LowQuality
CGAGAAGGTCGACTGC-1	GoodQuality
CGAGAAGGTGGGTCAA-1	GoodQuality
CGAGAAGGTTACTGAC-1	GoodQuality
CGAGAAGGTTGTGGAG-1	GoodQuality
CGAGAAGTCAAAGTAG-1	GoodQuality
CGAGAAGTCAACTCTT-1	GoodQuality
CGAGAAGTCACAGTAC-1	GoodQuality
CGAGAAGTCCCACTTG-1	GoodQuality
CGAGAAGTCGGCTTGG-1	LowQuality
CGAGCACAGTACACCT-1	GoodQuality
CGAGCACAGTCATCCA-1	GoodQuality
CGAGCACAGTTAACGA-1	LowQuality
CGAGCACTCAACCATG-1	GoodQuality
CGAGCACTCCACGTGG-1	GoodQuality
CGAGCACTCCCAACGG-1	LowQuality
CGAGCCAAGAAGGTGA-1	GoodQuality
CGAGCCACAAGTACCT-1	GoodQuality
CGAGCCACAGCGTCCA-1	GoodQuality
CGAGCCACATTCTCAT-1	GoodQuality
CGAGCCAGTCATCCCT-1	LowQuality
CGAGCCAGTTCCGTCT-1	GoodQuality
CGAGCCATCTTGACGA-1	LowQuality
CGATCGGAGCGTAATA-1	GoodQuality
CGATCGGAGTAGGTGC-1	GoodQuality
CGATCGGCAACTGCTA-1	LowQuality
CGATCGGCACGGTGTC-1	GoodQuality
CGATCGGCATTCCTGC-1	LowQuality
CGATCGGGTAGGAGTC-1	LowQuality
CGATCGGGTTGTTTGG-1	GoodQuality
CGATCGGTCACTTCAT-1	GoodQuality
CGATGGCAGAGCCCAA-1	LowQuality
CGATGGCAGATCGATA-1	LowQuality
CGATGGCAGTCGTTTG-1	GoodQuality
CGATGGCAGTTCGCAT-1	GoodQuality
CGATGGCCAGCCTTGG-1	LowQuality
CGATGGCCAGGTTTCA-1	GoodQuality
CGATGGCCATTTCACT-1	GoodQuality
CGATGGCGTAAAGGAG-1	LowQuality
CGATGGCGTTCGGCAC-1	GoodQuality
CGATGGCTCGGAGGTA-1	GoodQuality
CGATGTAAGATGTTAG-1	GoodQuality
CGATGTAAGCGTGAGT-1	GoodQuality
CGATGTAAGCTGCAAG-1	LowQuality
CGATGTACACTTGGAT-1	GoodQuality
CGATGTAGTCTTGCGG-1	GoodQuality
CGATGTAGTTTGTTTC-1	GoodQuality
CGATGTATCCCATTAT-1	GoodQuality
CGATGTATCTGACCTC-1	GoodQuality
CGATTGAAGATCACGG-1	GoodQuality
CGATTGAAGCTATGCT-1	GoodQuality
CGATTGAAGCTGCAAG-1	LowQuality
CGATTGAAGGAATGGA-1	GoodQuality
CGATTGACAACTGGCC-1	GoodQuality
CGATTGACACGGTGTC-1	GoodQuality
CGATTGACAGTATGCT-1	GoodQuality
CGATTGAGTAAAGGAG-1	GoodQuality
CGATTGAGTGTAATGA-1	GoodQuality
CGATTGAGTTCAACCA-1	GoodQuality
CGATTGATCACGACTA-1	GoodQuality
CGATTGATCCAAGCCG-1	GoodQuality
CGATTGATCGAATCCA-1	GoodQuality
CGATTGATCGGATGTT-1	LowQuality
CGCCAAGAGAGGTTGC-1	LowQuality
CGCCAAGAGGCTAGGT-1	LowQuality
CGCCAAGAGTACGATA-1	GoodQuality
CGCCAAGCAGGTCCAC-1	LowQuality
CGCCAAGTCCGAACGC-1	GoodQuality
CGCCAAGTCCGCAGTG-1	LowQuality
CGCCAAGTCGTGGGAA-1	GoodQuality
CGCGGTAAGCACAGGT-1	GoodQuality
CGCGGTAAGTTACCCA-1	GoodQuality
CGCGGTACAAGGTGTG-1	GoodQuality
CGCGGTACATCCGCGA-1	LowQuality
CGCGGTAGTACCGAGA-1	LowQuality
CGCGGTAGTAGCTGCC-1	GoodQuality
CGCGGTAGTAGGAGTC-1	LowQuality
CGCGGTAGTGATGTCT-1	GoodQuality
CGCGGTAGTTGTACAC-1	LowQuality
CGCGGTATCACGATGT-1	GoodQuality
CGCGGTATCTTGTATC-1	GoodQuality
CGCGTTTAGATGTTAG-1	LowQuality
CGCGTTTAGCGATATA-1	GoodQuality
CGCGTTTAGCTGAAAT-1	GoodQuality
CGCGTTTAGTGTTGAA-1	LowQuality
CGCGTTTCAACTGCGC-1	GoodQuality
CGCGTTTCAAGTAGTA-1	GoodQuality
CGCGTTTCAATGTAAG-1	GoodQuality
CGCGTTTGTACCTACA-1	GoodQuality
CGCGTTTGTCTCTTAT-1	GoodQuality
CGCGTTTGTTGCTCCT-1	LowQuality
CGCGTTTTCAGAAATG-1	LowQuality
CGCGTTTTCGGAGCAA-1	GoodQuality
CGCTATCAGCACGCCT-1	LowQuality
CGCTATCAGGCTAGCA-1	LowQuality
CGCTATCAGTGTACTC-1	GoodQuality
CGCTATCCATTTCAGG-1	GoodQuality
CGCTATCGTAGAGTGC-1	GoodQuality
CGCTATCGTCATATGC-1	LowQuality
CGCTATCGTTCGCGAC-1	LowQuality
CGCTATCTCCCAAGAT-1	GoodQuality
CGCTATCTCCGTTGCT-1	LowQuality
CGCTGGAAGAGCCCAA-1	LowQuality
CGCTGGAAGAGGGATA-1	GoodQuality
CGCTGGAAGGCTACGA-1	LowQuality
CGCTGGAAGGTGCAAC-1	LowQuality
CGCTGGACAATCCGAT-1	GoodQuality
CGCTGGACACTTCGAA-1	GoodQuality
CGCTGGAGTCTAGTGT-1	GoodQuality
CGCTGGAGTGCAGGTA-1	GoodQuality
CGCTGGATCGGCGGTT-1	LowQuality
CGCTGGATCTTGGGTA-1	GoodQuality
CGCTTCAAGAGCTATA-1	GoodQuality
CGCTTCAAGAGGACGG-1	GoodQuality
CGCTTCAAGCCAACAG-1	GoodQuality
CGCTTCAAGGAATTAC-1	GoodQuality
CGCTTCACAAACCCAT-1	GoodQuality
CGCTTCACAAGCGATG-1	GoodQuality
CGCTTCACAGTATGCT-1	LowQuality
CGCTTCAGTACCTACA-1	GoodQuality
CGCTTCAGTCAAACTC-1	GoodQuality
CGCTTCAGTGTTTGGT-1	GoodQuality
CGCTTCATCAACGAAA-1	GoodQuality
CGCTTCATCCACGTGG-1	LowQuality
CGCTTCATCCGTAGGC-1	GoodQuality
CGCTTCATCGGTGTTA-1	LowQuality
CGCTTCATCTACTCAT-1	GoodQuality
CGCTTCATCTCCTATA-1	GoodQuality
CGGACACAGCCGGTAA-1	GoodQuality
CGGACACAGTGAATTG-1	LowQuality
CGGACACAGTGGAGAA-1	LowQuality
CGGACACAGTGTACTC-1	LowQuality
CGGACACCAAACCCAT-1	GoodQuality
CGGACACCACCAGGCT-1	GoodQuality
CGGACACCAGACAAGC-1	GoodQuality
CGGACACCATGCAACT-1	LowQuality
CGGACACGTCTCCCTA-1	GoodQuality
CGGACACGTCTCGTTC-1	LowQuality
CGGACACGTTGCCTCT-1	GoodQuality
CGGACACTCTAGCACA-1	GoodQuality
CGGACGTAGCACACAG-1	GoodQuality
CGGACGTAGCGTTCCG-1	GoodQuality
CGGACGTAGGACTGGT-1	GoodQuality
CGGACGTCACTTGGAT-1	GoodQuality
CGGACGTGTACCGGCT-1	GoodQuality
CGGACGTGTGAGCGAT-1	LowQuality
CGGACGTGTGGAAAGA-1	GoodQuality
CGGACGTGTTGATTGC-1	GoodQuality
CGGACGTTCCAGAAGG-1	LowQuality
CGGACGTTCTAACGGT-1	GoodQuality
CGGACGTTCTGCCAGG-1	LowQuality
CGGACGTTCTGGTATG-1	GoodQuality
CGGACGTTCTTCATGT-1	GoodQuality
CGGACTGAGATAGGAG-1	GoodQuality
CGGACTGCAATGAAAC-1	LowQuality
CGGACTGCATGTAGTC-1	GoodQuality
CGGACTGGTCACCTAA-1	LowQuality
CGGACTGTCCTCAATT-1	GoodQuality
CGGACTGTCCTTTACA-1	LowQuality
CGGACTGTCGCTTAGA-1	GoodQuality
CGGACTGTCGTTTATC-1	GoodQuality
CGGAGCTAGGACACCA-1	LowQuality
CGGAGCTCACATGACT-1	GoodQuality
CGGAGCTCAGGGTATG-1	GoodQuality
CGGAGCTGTAAGTGTA-1	GoodQuality
CGGAGCTGTCATCGGC-1	GoodQuality
CGGAGCTGTCCTCCAT-1	LowQuality
CGGAGCTGTTCGCGAC-1	GoodQuality
CGGAGCTGTTTAGCTG-1	GoodQuality
CGGAGCTTCAACGCTA-1	LowQuality
CGGAGCTTCACCAGGC-1	LowQuality
CGGAGCTTCACGATGT-1	GoodQuality
CGGAGCTTCGCGATCG-1	GoodQuality
CGGAGCTTCTGTCTCG-1	GoodQuality
CGGAGTCAGCACAGGT-1	LowQuality
CGGAGTCAGGATTCGG-1	GoodQuality
CGGAGTCAGTAGATGT-1	GoodQuality
CGGAGTCCAAGACACG-1	GoodQuality
CGGAGTCCAAGACGTG-1	GoodQuality
CGGAGTCCAATCGGTT-1	GoodQuality
CGGAGTCCACCTTGTC-1	LowQuality
CGGAGTCCACTAGTAC-1	LowQuality
CGGAGTCGTAGCTTGT-1	GoodQuality
CGGAGTCGTATCAGTC-1	LowQuality
CGGAGTCGTTGCTCCT-1	GoodQuality
CGGAGTCTCAACACGT-1	GoodQuality
CGGAGTCTCGCATGAT-1	LowQuality
CGGCTAGCACCCTATC-1	GoodQuality
CGGCTAGCAGCCAGAA-1	GoodQuality
CGGCTAGCATGGGACA-1	LowQuality
CGGCTAGGTCAGATAA-1	GoodQuality
CGGCTAGGTGATGATA-1	GoodQuality
CGGCTAGGTGCAACGA-1	LowQuality
CGGCTAGGTGGTCTCG-1	LowQuality
CGGGTCAAGATATGCA-1	GoodQuality
CGGGTCAAGGGAGTAA-1	GoodQuality
CGGGTCAAGTCTCCTC-1	GoodQuality
CGGGTCACAACGATCT-1	GoodQuality
CGGGTCACAACGATGG-1	GoodQuality
CGGGTCACAATCAGAA-1	LowQuality
CGGGTCACAGTGACAG-1	LowQuality
CGGGTCAGTAAGAGGA-1	GoodQuality
CGGGTCAGTACCAGTT-1	LowQuality
CGGGTCAGTAGCGCTC-1	GoodQuality
CGGGTCAGTCTCTTTA-1	GoodQuality
CGGGTCAGTTCCATGA-1	GoodQuality
CGGGTCATCAATACCG-1	GoodQuality
CGGTTAAAGTCAATAG-1	GoodQuality
CGGTTAAAGTGGGATC-1	GoodQuality
CGGTTAACAAGCGAGT-1	GoodQuality
CGGTTAACACAAGTAA-1	LowQuality
CGGTTAACAGACAGGT-1	LowQuality
CGGTTAATCGGCGGTT-1	GoodQuality
CGTAGCGAGCGATCCC-1	LowQuality
CGTAGCGAGGATGGAA-1	GoodQuality
CGTAGCGAGGCTAGAC-1	LowQuality
CGTAGCGAGTGCGATG-1	LowQuality
CGTAGCGCAATGTTGC-1	GoodQuality
CGTAGCGCACATTAGC-1	LowQuality
CGTAGCGCAGCGTAAG-1	GoodQuality
CGTAGCGCATCGTCGG-1	GoodQuality
CGTAGCGGTCAAGCGA-1	GoodQuality
CGTAGCGGTCGTTGTA-1	GoodQuality
CGTAGCGGTGTAAGTA-1	LowQuality
CGTAGCGGTTGAACTC-1	GoodQuality
CGTAGCGTCAGGCGAA-1	GoodQuality
CGTAGCGTCGGATGTT-1	GoodQuality
CGTAGCGTCGTAGATC-1	GoodQuality
CGTAGGCAGAAGGGTA-1	GoodQuality
CGTAGGCAGGTTACCT-1	GoodQuality
CGTAGGCAGTAGATGT-1	GoodQuality
CGTAGGCCATATACCG-1	GoodQuality
CGTAGGCGTGCAGTAG-1	LowQuality
CGTAGGCTCAACTCTT-1	LowQuality
CGTAGGCTCTTCGAGA-1	LowQuality
CGTCACTAGCACCGTC-1	GoodQuality
CGTCACTAGGAGCGTT-1	GoodQuality
CGTCACTAGTTTCCTT-1	LowQuality
CGTCACTCACGAGGTA-1	LowQuality
CGTCACTCAGGGTTAG-1	LowQuality
CGTCACTCATCACAAC-1	GoodQuality
CGTCACTCATCACGAT-1	GoodQuality
CGTCACTGTACGCTGC-1	LowQuality
CGTCACTGTCCTAGCG-1	GoodQuality
CGTCACTTCGTTGACA-1	LowQuality
CGTCACTTCTTAACCT-1	GoodQuality
CGTCACTTCTTTAGGG-1	GoodQuality
CGTCAGGAGATGCGAC-1	GoodQuality
CGTCAGGAGCACAGGT-1	GoodQuality
CGTCAGGCATCCTTGC-1	GoodQuality
CGTCAGGCATGGGAAC-1	GoodQuality
CGTCAGGCATTGTGCA-1	LowQuality
CGTCAGGGTCTGCCAG-1	GoodQuality
CGTCAGGGTGAGTGAC-1	GoodQuality
CGTCAGGTCACCGTAA-1	GoodQuality
CGTCAGGTCCGATATG-1	GoodQuality
CGTCAGGTCCTCGCAT-1	GoodQuality
CGTCCATAGATACACA-1	GoodQuality
CGTCCATAGCAGGCTA-1	GoodQuality
CGTCCATAGCCAGTAG-1	GoodQuality
CGTCCATAGCTAGTTC-1	LowQuality
CGTCCATAGTATGACA-1	GoodQuality
CGTCCATAGTCCAGGA-1	GoodQuality
CGTCCATCAAGCCCAC-1	GoodQuality
CGTCCATCACCATCCT-1	GoodQuality
CGTCCATCACCCTATC-1	GoodQuality
CGTCCATCACGGCCAT-1	GoodQuality
CGTCCATCACTGTTAG-1	GoodQuality
CGTCCATCAGGTTTCA-1	GoodQuality
CGTCCATCAGTAAGAT-1	GoodQuality
CGTCCATGTAAAGTCA-1	GoodQuality
CGTCCATGTACGCTGC-1	GoodQuality
CGTCCATGTAGCGCTC-1	GoodQuality
CGTCCATGTAGGGACT-1	GoodQuality
CGTCCATGTCCAGTGC-1	LowQuality
CGTCCATGTCGAGTTT-1	LowQuality
CGTCCATGTCTACCTC-1	GoodQuality
CGTCCATGTGACTCAT-1	LowQuality
CGTCCATGTGCTGTAT-1	GoodQuality
CGTCCATGTTAAGACA-1	GoodQuality
CGTCCATTCGAGAGCA-1	LowQuality
CGTCCATTCTTGCAAG-1	GoodQuality
CGTCTACAGACCACGA-1	GoodQuality
CGTCTACAGTAACCCT-1	GoodQuality
CGTCTACCACATCCGG-1	LowQuality
CGTCTACCACGTCAGC-1	GoodQuality
CGTCTACCATCGGTTA-1	GoodQuality
CGTCTACGTCTAGGTT-1	GoodQuality
CGTCTACGTGTGAATA-1	GoodQuality
CGTCTACGTTACAGAA-1	LowQuality
CGTGAGCAGCCTATGT-1	LowQuality
CGTGAGCAGCGTTCCG-1	LowQuality
CGTGAGCAGCTCTCGG-1	LowQuality
CGTGAGCAGGAATCGC-1	GoodQuality
CGTGAGCAGGGAGTAA-1	GoodQuality
CGTGAGCAGTAGGTGC-1	GoodQuality
CGTGAGCCACCCAGTG-1	GoodQuality
CGTGAGCCATATGAGA-1	LowQuality
CGTGAGCGTCCAAGTT-1	GoodQuality
CGTGAGCGTTAAGACA-1	GoodQuality
CGTGAGCTCCAAGTAC-1	GoodQuality
CGTGAGCTCTACTTAC-1	LowQuality
CGTGAGCTCTGCTGTC-1	LowQuality
CGTGTAAAGGCAATTA-1	GoodQuality
CGTGTAAAGGCTAGCA-1	LowQuality
CGTGTAAAGGGCTTGA-1	GoodQuality
CGTGTAACAGTAAGAT-1	GoodQuality
CGTGTAACATGCATGT-1	GoodQuality
CGTGTAACATTTCACT-1	GoodQuality
CGTGTAATCCGAAGAG-1	GoodQuality
CGTGTAATCGTCTGCT-1	GoodQuality
CGTGTAATCTTTCCTC-1	LowQuality
CGTGTCTAGATGTGTA-1	GoodQuality
CGTGTCTAGCGTAATA-1	GoodQuality
CGTGTCTAGGTCATCT-1	GoodQuality
CGTGTCTCATTCCTGC-1	GoodQuality
CGTGTCTGTACAGTTC-1	GoodQuality
CGTGTCTGTCTAGTCA-1	GoodQuality
CGTGTCTTCTATCCCG-1	GoodQuality
CGTGTCTTCTGCGTAA-1	LowQuality
CGTTAGAAGATACACA-1	GoodQuality
CGTTAGAAGATGCCTT-1	GoodQuality
CGTTAGAAGCGTGAGT-1	LowQuality
CGTTAGAAGCTAACAA-1	GoodQuality
CGTTAGAAGTTAGCGG-1	LowQuality
CGTTAGACAACACGCC-1	GoodQuality
CGTTAGACAAGTTAAG-1	GoodQuality
CGTTAGACACGGTTTA-1	GoodQuality
CGTTAGAGTACTCGCG-1	GoodQuality
CGTTAGAGTACTTCTT-1	LowQuality
CGTTAGAGTCCGTCAG-1	LowQuality
CGTTAGATCAAACAAG-1	GoodQuality
CGTTCTGAGATACACA-1	GoodQuality
CGTTCTGAGGCCATAG-1	GoodQuality
CGTTCTGCAAGAGGCT-1	GoodQuality
CGTTCTGCATCAGTCA-1	GoodQuality
CGTTCTGCATTGGCGC-1	GoodQuality
CGTTCTGGTGATGTCT-1	LowQuality
CGTTCTGTCAATACCG-1	LowQuality
CGTTCTGTCCTCCTAG-1	GoodQuality
CGTTGGGAGTAGTGCG-1	GoodQuality
CGTTGGGAGTCTTGCA-1	GoodQuality
CGTTGGGAGTGTGAAT-1	GoodQuality
CGTTGGGCAGTAGAGC-1	GoodQuality
CGTTGGGGTAATTGGA-1	LowQuality
CGTTGGGGTGTTTGTG-1	GoodQuality
CGTTGGGGTTCCTCCA-1	GoodQuality
CGTTGGGTCCTGCTTG-1	LowQuality
CGTTGGGTCGCCTGTT-1	GoodQuality
CTAACTTAGCGTGAGT-1	GoodQuality
CTAACTTGTCGCCATG-1	LowQuality
CTAACTTGTGATGTCT-1	LowQuality
CTAACTTGTTAGTGGG-1	LowQuality
CTAACTTTCCGCATCT-1	LowQuality
CTAACTTTCGAGAACG-1	GoodQuality
CTAAGACAGAGTAAGG-1	GoodQuality
CTAAGACCAAAGTCAA-1	GoodQuality
CTAAGACTCTACTATC-1	LowQuality
CTAATGGAGCAGACTG-1	GoodQuality
CTAATGGAGGTGTGGT-1	GoodQuality
CTAATGGCAAGCCCAC-1	GoodQuality
CTAATGGCAATCTACG-1	LowQuality
CTAATGGCACAGTCGC-1	GoodQuality
CTAATGGCATAAAGGT-1	GoodQuality
CTAATGGGTAGCCTCG-1	GoodQuality
CTAATGGGTGAACCTT-1	GoodQuality
CTAATGGGTTTGACTG-1	LowQuality
CTAATGGGTTTGGGCC-1	GoodQuality
CTAATGGTCAGTTGAC-1	LowQuality
CTAATGGTCCCTTGTG-1	LowQuality
CTAATGGTCTTATCTG-1	GoodQuality
CTACACCAGAGCCTAG-1	GoodQuality
CTACACCAGAGCTGGT-1	GoodQuality
CTACACCAGCCACGCT-1	LowQuality
CTACACCAGCTCCTCT-1	LowQuality
CTACACCAGGTACTCT-1	LowQuality
CTACACCCAAGTTAAG-1	GoodQuality
CTACACCCACGGCCAT-1	GoodQuality
CTACACCCAGGTCGTC-1	GoodQuality
CTACACCGTTCTGAAC-1	GoodQuality
CTACACCTCTCCAACC-1	LowQuality
CTACATTAGAGCTGCA-1	GoodQuality
CTACATTAGCTCAACT-1	GoodQuality
CTACATTAGTCACGCC-1	GoodQuality
CTACATTCAACACGCC-1	GoodQuality
CTACATTGTCATTAGC-1	GoodQuality
CTACATTGTCCGTGAC-1	GoodQuality
CTACATTGTGAACCTT-1	LowQuality
CTACATTGTTACGGAG-1	GoodQuality
CTACATTTCCTGTAGA-1	GoodQuality
CTACATTTCGTGACAT-1	GoodQuality
CTACATTTCTGTACGA-1	GoodQuality
CTACCCAAGATCGATA-1	LowQuality
CTACCCAAGCTGAACG-1	LowQuality
CTACCCACACAGCGTC-1	LowQuality
CTACCCACACAGGTTT-1	GoodQuality
CTACCCACAGATGGCA-1	GoodQuality
CTACCCACAGGGTTAG-1	LowQuality
CTACCCACAGTCACTA-1	GoodQuality
CTACCCACAGTGACAG-1	GoodQuality
CTACCCAGTAGAGTGC-1	GoodQuality
CTACCCAGTGGGTCAA-1	LowQuality
CTACCCATCACAATGC-1	GoodQuality
CTACGTCAGCCAACAG-1	GoodQuality
CTACGTCCAGTGACAG-1	GoodQuality
CTACGTCCAGTTTACG-1	LowQuality
CTACGTCTCACTCCTG-1	LowQuality
CTACGTCTCGAGAGCA-1	LowQuality
CTACGTCTCGCGGATC-1	LowQuality
CTAGAGTAGCACAGGT-1	GoodQuality
CTAGAGTAGGAGCGTT-1	GoodQuality
CTAGAGTAGTTAGCGG-1	LowQuality
CTAGAGTCAAGTCTAC-1	GoodQuality
CTAGAGTCACGACTCG-1	GoodQuality
CTAGAGTCACGTCTCT-1	LowQuality
CTAGAGTCATACCATG-1	GoodQuality
CTAGAGTCATATGAGA-1	GoodQuality
CTAGAGTCATGCGCAC-1	LowQuality
CTAGAGTGTTCTGAAC-1	LowQuality
CTAGAGTTCACCAGGC-1	LowQuality
CTAGAGTTCCGCGTTT-1	GoodQuality
CTAGAGTTCTGCAAGT-1	LowQuality
CTAGAGTTCTTAACCT-1	GoodQuality
CTAGCCTAGAATTGTG-1	GoodQuality
CTAGCCTAGGTCGGAT-1	GoodQuality
CTAGCCTAGTCGTACT-1	LowQuality
CTAGCCTCAGCCTGTG-1	LowQuality
CTAGCCTGTACAGTTC-1	GoodQuality
CTAGCCTGTTTGACAC-1	GoodQuality
CTAGCCTTCGAATGCT-1	LowQuality
CTAGCCTTCGGTGTCG-1	GoodQuality
CTAGTGAAGCCTTGAT-1	GoodQuality
CTAGTGAAGGTACTCT-1	GoodQuality
CTAGTGAAGTCATGCT-1	GoodQuality
CTAGTGACAGCGTTCG-1	LowQuality
CTAGTGAGTCGGCATC-1	GoodQuality
CTAGTGATCGTCACGG-1	GoodQuality
CTAGTGATCTTCCTTC-1	LowQuality
CTAGTGATCTTTACGT-1	LowQuality
CTCACACAGCCACTAT-1	LowQuality
CTCACACAGCGCCTCA-1	GoodQuality
CTCACACAGGATGCGT-1	GoodQuality
CTCACACAGGCCATAG-1	GoodQuality
CTCACACCAGGAATCG-1	GoodQuality
CTCACACCAGTGGGAT-1	GoodQuality
CTCACACCATCATCCC-1	GoodQuality
CTCACACGTCCGTTAA-1	GoodQuality
CTCACACGTCTGGAGA-1	LowQuality
CTCACACTCAAGAAGT-1	GoodQuality
CTCACACTCATCATTC-1	LowQuality
CTCAGAAAGAAACCTA-1	GoodQuality
CTCAGAAAGAAGGACA-1	LowQuality
CTCAGAAAGACAAAGG-1	LowQuality
CTCAGAACACAGGCCT-1	GoodQuality
CTCAGAACAGATGAGC-1	GoodQuality
CTCAGAACAGCAGTTT-1	GoodQuality
CTCAGAAGTCGCCATG-1	LowQuality
CTCAGAAGTCTGCAAT-1	LowQuality
CTCAGAAGTGATGCCC-1	GoodQuality
CTCAGAATCTACTCAT-1	GoodQuality
CTCATTACAAGGTGTG-1	LowQuality
CTCATTACACTCAGGC-1	LowQuality
CTCATTAGTATGAATG-1	GoodQuality
CTCATTAGTCGTTGTA-1	GoodQuality
CTCATTAGTTCAGGCC-1	GoodQuality
CTCATTAGTTGGTAAA-1	LowQuality
CTCATTATCAGGCAAG-1	GoodQuality
CTCATTATCATGTGGT-1	LowQuality
CTCCTAGAGAATGTGT-1	GoodQuality
CTCCTAGAGAGTACCG-1	GoodQuality
CTCCTAGAGTCGCCGT-1	LowQuality
CTCCTAGCAAAGGTGC-1	GoodQuality
CTCCTAGCAAGGTGTG-1	GoodQuality
CTCCTAGGTAAACACA-1	GoodQuality
CTCCTAGGTCACTTCC-1	GoodQuality
CTCCTAGGTTTCGCTC-1	GoodQuality
CTCCTAGTCCATGAAC-1	GoodQuality
CTCCTAGTCCCTCAGT-1	LowQuality
CTCCTAGTCCCTTGTG-1	LowQuality
CTCCTAGTCCGCATAA-1	LowQuality
CTCCTAGTCTTTACAC-1	LowQuality
CTCGAAAAGACGCAAC-1	GoodQuality
CTCGAAACACAAGTAA-1	GoodQuality
CTCGAAAGTCCTGCTT-1	LowQuality
CTCGAAATCAGAGCTT-1	GoodQuality
CTCGAGGAGCGATAGC-1	GoodQuality
CTCGAGGAGCTAGCCC-1	LowQuality
CTCGAGGAGGCTAGCA-1	LowQuality
CTCGAGGAGTTGTAGA-1	GoodQuality
CTCGAGGCACAGACAG-1	GoodQuality
CTCGAGGGTCGAACAG-1	GoodQuality
CTCGAGGGTCGAATCT-1	LowQuality
CTCGAGGTCAAAGTAG-1	LowQuality
CTCGAGGTCAATACCG-1	GoodQuality
CTCGAGGTCCATGCTC-1	LowQuality
CTCGAGGTCCGAACGC-1	GoodQuality
CTCGGAGAGGCAATTA-1	LowQuality
CTCGGAGAGTCAAGGC-1	GoodQuality
CTCGGAGCACAAGTAA-1	GoodQuality
CTCGGAGCACGGTTTA-1	GoodQuality
CTCGGAGCAGACAGGT-1	GoodQuality
CTCGGAGGTAAACGCG-1	LowQuality
CTCGGAGGTCTAAACC-1	LowQuality
CTCGGGAAGACGCTTT-1	LowQuality
CTCGGGATCAACACGT-1	LowQuality
CTCGGGATCATGCTCC-1	GoodQuality
CTCGTACAGAAACGCC-1	GoodQuality
CTCGTACAGATGTTAG-1	GoodQuality
CTCGTACAGGGCATGT-1	GoodQuality
CTCGTACCAAGGTTTC-1	LowQuality
CTCGTACCAGACGTAG-1	LowQuality
CTCGTACCATCCGCGA-1	GoodQuality
CTCGTACGTCCGAATT-1	GoodQuality
CTCGTACTCACGCATA-1	LowQuality
CTCGTACTCCACGAAT-1	GoodQuality
CTCGTCACATCACCCT-1	GoodQuality
CTCGTCACATCCAACA-1	GoodQuality
CTCGTCACATGCGCAC-1	GoodQuality
CTCGTCAGTAGAGTGC-1	GoodQuality
CTCGTCAGTATCACCA-1	LowQuality
CTCGTCAGTATGCTTG-1	LowQuality
CTCGTCAGTCCGCTGA-1	GoodQuality
CTCGTCAGTCTAAACC-1	LowQuality
CTCGTCAGTGTTCTTT-1	LowQuality
CTCGTCAGTTGTGGAG-1	LowQuality
CTCGTCAGTTTACTCT-1	LowQuality
CTCGTCATCCAGTAGT-1	GoodQuality
CTCGTCATCTTGACGA-1	LowQuality
CTCTAATAGATTACCC-1	GoodQuality
CTCTAATAGCAAATCA-1	LowQuality
CTCTAATAGCCCAACC-1	GoodQuality
CTCTAATAGGACAGAA-1	LowQuality
CTCTAATAGTACGATA-1	LowQuality
CTCTAATAGTGTCCCG-1	GoodQuality
CTCTAATCACTTAAGC-1	GoodQuality
CTCTAATCAGCGTTCG-1	GoodQuality
CTCTAATGTGAAAGAG-1	GoodQuality
CTCTAATGTGCCTGCA-1	LowQuality
CTCTAATGTGGCCCTA-1	GoodQuality
CTCTAATGTGTGCCTG-1	GoodQuality
CTCTAATGTTCCACGG-1	GoodQuality
CTCTAATTCACTATTC-1	LowQuality
CTCTAATTCATGTCCC-1	LowQuality
CTCTAATTCCTCGCAT-1	LowQuality
CTCTAATTCGGGAGTA-1	GoodQuality
CTCTACGCAGATCTGT-1	LowQuality
CTCTACGCATGAAGTA-1	LowQuality
CTCTACGGTGCACCAC-1	GoodQuality
CTCTACGGTTCGTTGA-1	GoodQuality
CTCTACGTCACGACTA-1	LowQuality
CTCTACGTCGCCAGCA-1	GoodQuality
CTCTGGTAGAGGTACC-1	LowQuality
CTCTGGTAGAGTGACC-1	LowQuality
CTCTGGTAGGTGATAT-1	GoodQuality
CTCTGGTCAATCCAAC-1	GoodQuality
CTCTGGTCACATCCAA-1	GoodQuality
CTCTGGTCAGGAATGC-1	LowQuality
CTCTGGTCAGGGATTG-1	GoodQuality
CTCTGGTGTAAGGGAA-1	GoodQuality
CTCTGGTGTTTGCATG-1	GoodQuality
CTCTGGTTCCCATTTA-1	GoodQuality
CTCTGGTTCTTGACGA-1	LowQuality
CTGAAACAGAAGGTGA-1	GoodQuality
CTGAAACAGACCTAGG-1	LowQuality
CTGAAACAGAGACTAT-1	GoodQuality
CTGAAACAGTAGGCCA-1	GoodQuality
CTGAAACCAAGCCTAT-1	GoodQuality
CTGAAACCACCGATAT-1	LowQuality
CTGAAACCAGGACGTA-1	GoodQuality
CTGAAACGTCATTAGC-1	LowQuality
CTGAAACGTTAAGACA-1	GoodQuality
CTGAAACGTTGTTTGG-1	LowQuality
CTGAAACTCACCAGGC-1	LowQuality
CTGAAACTCAGTGCAT-1	GoodQuality
CTGAAACTCCGTTGTC-1	GoodQuality
CTGAAGTAGACACGAC-1	GoodQuality
CTGAAGTAGATAGCAT-1	LowQuality
CTGAAGTAGCGTCAAG-1	GoodQuality
CTGAAGTAGGAATCGC-1	LowQuality
CTGAAGTAGTATCGAA-1	LowQuality
CTGAAGTAGTCATGCT-1	GoodQuality
CTGAAGTCAGATTGCT-1	LowQuality
CTGAAGTCAGCTTAAC-1	GoodQuality
CTGAAGTCATTGTGCA-1	GoodQuality
CTGAAGTGTCACTTCC-1	LowQuality
CTGAAGTGTTGAACTC-1	GoodQuality
CTGAAGTTCGACGGAA-1	GoodQuality
CTGATAGAGCGAGAAA-1	GoodQuality
CTGATAGAGGGCTTCC-1	GoodQuality
CTGATAGAGTAGATGT-1	GoodQuality
CTGATAGCACGTCAGC-1	GoodQuality
CTGATAGCAGATAATG-1	GoodQuality
CTGATAGGTCACCTAA-1	LowQuality
CTGATAGGTGTTTGGT-1	LowQuality
CTGATAGGTTCGTTGA-1	GoodQuality
CTGATAGTCACCACCT-1	LowQuality
CTGATAGTCAGCTTAG-1	LowQuality
CTGATAGTCATCGCTC-1	GoodQuality
CTGATAGTCCAGAAGG-1	LowQuality
CTGATAGTCGGCGCAT-1	GoodQuality
CTGATAGTCGTTGACA-1	GoodQuality
CTGATAGTCTGAAAGA-1	GoodQuality
CTGATCCAGACAGACC-1	LowQuality
CTGATCCAGTGACATA-1	GoodQuality
CTGATCCAGTTCGATC-1	GoodQuality
CTGATCCCAATACGCT-1	GoodQuality
CTGATCCCAATGGAGC-1	LowQuality
CTGATCCCACAGGCCT-1	GoodQuality
CTGATCCGTGTCGCTG-1	GoodQuality
CTGCCTAAGCCTTGAT-1	LowQuality
CTGCCTAAGCTAGCCC-1	LowQuality
CTGCCTACATGCAATC-1	GoodQuality
CTGCCTACATGGTTGT-1	GoodQuality
CTGCCTATCACAAACC-1	GoodQuality
CTGCCTATCCAAGTAC-1	GoodQuality
CTGCCTATCTACTCAT-1	GoodQuality
CTGCCTATCTGATACG-1	LowQuality
CTGCCTATCTTAGCCC-1	LowQuality
CTGCGGACACATGACT-1	GoodQuality
CTGCGGACATACTACG-1	GoodQuality
CTGCGGAGTAGGACAC-1	GoodQuality
CTGCGGAGTCTACCTC-1	LowQuality
CTGCGGAGTGAAATCA-1	GoodQuality
CTGCGGATCCAGGGCT-1	GoodQuality
CTGCGGATCGGAAATA-1	LowQuality
CTGCTGTAGCGTCAAG-1	GoodQuality
CTGCTGTAGTGGTAAT-1	GoodQuality
CTGCTGTCAAGAGTCG-1	GoodQuality
CTGCTGTCACCCAGTG-1	GoodQuality
CTGCTGTCACGACTCG-1	GoodQuality
CTGCTGTCAGCTGTTA-1	GoodQuality
CTGCTGTGTATCAGTC-1	LowQuality
CTGCTGTGTCAACATC-1	GoodQuality
CTGGTCTCACCCAGTG-1	LowQuality
CTGGTCTCAGTTCCCT-1	GoodQuality
CTGGTCTCATGGGAAC-1	LowQuality
CTGGTCTGTATCAGTC-1	GoodQuality
CTGGTCTGTCACCTAA-1	LowQuality
CTGGTCTGTCACTGGC-1	GoodQuality
CTGGTCTGTCATTAGC-1	GoodQuality
CTGGTCTGTGGTACAG-1	LowQuality
CTGGTCTTCATCGATG-1	LowQuality
CTGGTCTTCTTGTTTG-1	GoodQuality
CTGTGCTAGAGCAATT-1	GoodQuality
CTGTGCTAGATGCCTT-1	LowQuality
CTGTGCTAGGACAGAA-1	GoodQuality
CTGTGCTAGTACACCT-1	GoodQuality
CTGTGCTAGTGAACAT-1	GoodQuality
CTGTGCTCAATAGCGG-1	GoodQuality
CTGTGCTCATCTACGA-1	LowQuality
CTGTGCTCATGCGCAC-1	LowQuality
CTGTGCTCATTTGCCC-1	GoodQuality
CTGTGCTGTCTCCACT-1	GoodQuality
CTGTGCTGTGAGTGAC-1	LowQuality
CTGTGCTGTGGTTTCA-1	LowQuality
CTGTGCTGTTGATTCG-1	LowQuality
CTGTGCTTCGAATGGG-1	GoodQuality
CTGTGCTTCGGTGTTA-1	GoodQuality
CTGTGCTTCTACTCAT-1	GoodQuality
CTGTGCTTCTCTTATG-1	GoodQuality
CTGTTTAAGAGGTAGA-1	GoodQuality
CTGTTTAAGCCAGGAT-1	GoodQuality
CTGTTTAAGCCCAATT-1	GoodQuality
CTGTTTAAGCGGCTTC-1	GoodQuality
CTGTTTAAGCTACCGC-1	LowQuality
CTGTTTACAACAACCT-1	GoodQuality
CTGTTTACACGAAAGC-1	LowQuality
CTGTTTAGTATATGGA-1	GoodQuality
CTGTTTAGTGAGGGAG-1	LowQuality
CTGTTTAGTGTAATGA-1	GoodQuality
CTGTTTATCCGCAGTG-1	GoodQuality
CTGTTTATCGAGAACG-1	GoodQuality
CTTAACTCACCGGAAA-1	GoodQuality
CTTAACTGTACCGCTG-1	GoodQuality
CTTAACTTCGTAGGTT-1	LowQuality
CTTACCGCACCTATCC-1	GoodQuality
CTTACCGCACTGCCAG-1	LowQuality
CTTACCGCATCGGAAG-1	GoodQuality
CTTACCGCATTACGAC-1	LowQuality
CTTACCGGTTATCGGT-1	GoodQuality
CTTACCGGTTCTCATT-1	LowQuality
CTTACCGTCACGGTTA-1	GoodQuality
CTTACCGTCCCAACGG-1	GoodQuality
CTTAGGAAGATATGCA-1	GoodQuality
CTTAGGAAGGGTGTGT-1	LowQuality
CTTAGGACACGAAACG-1	LowQuality
CTTAGGAGTGCGCTTG-1	GoodQuality
CTTAGGATCATAGCAC-1	LowQuality
CTTCTCTAGATGTCGG-1	GoodQuality
CTTCTCTAGCCACGTC-1	GoodQuality
CTTCTCTAGCTCAACT-1	GoodQuality
CTTCTCTAGTCCTCCT-1	LowQuality
CTTCTCTGTGACTACT-1	GoodQuality
CTTCTCTGTGTGCCTG-1	GoodQuality
CTTCTCTGTTGTACAC-1	GoodQuality
CTTGGCTAGATAGCAT-1	GoodQuality
CTTGGCTAGGGATACC-1	GoodQuality
CTTGGCTCAACAACCT-1	GoodQuality
CTTGGCTCAATCCGAT-1	LowQuality
CTTGGCTCACTAGTAC-1	GoodQuality
CTTGGCTGTCTCAACA-1	LowQuality
CTTGGCTGTTGATTCG-1	GoodQuality
CTTTGCGAGAATTGTG-1	LowQuality
CTTTGCGAGGGCTCTC-1	LowQuality
CTTTGCGAGGTGACCA-1	LowQuality
CTTTGCGCAAGACACG-1	GoodQuality
CTTTGCGCACGGCCAT-1	GoodQuality
CTTTGCGCACGGTTTA-1	GoodQuality
CTTTGCGCAGGGAGAG-1	GoodQuality
CTTTGCGCAGTTTACG-1	LowQuality
CTTTGCGGTAGGCTGA-1	LowQuality
CTTTGCGGTGTGCGTC-1	LowQuality
CTTTGCGGTTCGCTAA-1	GoodQuality
CTTTGCGGTTGCGCAC-1	GoodQuality
CTTTGCGTCCACGTTC-1	GoodQuality
CTTTGCGTCCGTTGCT-1	GoodQuality
CTTTGCGTCTGCCCTA-1	GoodQuality
CTTTGCGTCTTCCTTC-1	LowQuality
GAAACTCAGAGCCTAG-1	GoodQuality
GAAACTCAGATATGGT-1	GoodQuality
GAAACTCAGTAGCGGT-1	GoodQuality
GAAACTCAGTCCAGGA-1	GoodQuality
GAAACTCCAACACCTA-1	GoodQuality
GAAACTCCACAGACAG-1	GoodQuality
GAAACTCCACTTACGA-1	GoodQuality
GAAACTCGTCAATACC-1	GoodQuality
GAAACTCGTGGCGAAT-1	GoodQuality
GAAACTCGTGTGACCC-1	LowQuality
GAAACTCTCGGCTTGG-1	GoodQuality
GAAACTCTCTTGAGGT-1	LowQuality
GAAATGAAGATGTGGC-1	GoodQuality
GAAATGAAGCAGCCTC-1	LowQuality
GAAATGAAGCCCAATT-1	LowQuality
GAAATGAAGTCTTGCA-1	GoodQuality
GAAATGACAAACCCAT-1	GoodQuality
GAAATGACAAAGTGCG-1	GoodQuality
GAAATGACAAGTACCT-1	GoodQuality
GAAATGAGTCCAAGTT-1	GoodQuality
GAAATGAGTGAGGGTT-1	GoodQuality
GAAATGAGTGGTACAG-1	GoodQuality
GAAATGATCAGCGACC-1	GoodQuality
GAAATGATCTAGCACA-1	GoodQuality
GAAATGATCTCTTATG-1	GoodQuality
GAAATGATCTTCCTTC-1	GoodQuality
GAACATCAGAAGCCCA-1	GoodQuality
GAACATCAGATGTGTA-1	GoodQuality
GAACATCAGGATGGAA-1	GoodQuality
GAACATCAGTCTCAAC-1	GoodQuality
GAACATCCAAAGCGGT-1	GoodQuality
GAACATCCAAGTCTAC-1	GoodQuality
GAACATCCACCATGTA-1	LowQuality
GAACATCCACTTAAGC-1	GoodQuality
GAACATCCATTCCTGC-1	LowQuality
GAACATCGTGCAGACA-1	GoodQuality
GAACATCGTGGTAACG-1	GoodQuality
GAACATCTCACGCATA-1	GoodQuality
GAACCTAAGATAGGAG-1	GoodQuality
GAACCTAAGGTAAACT-1	GoodQuality
GAACCTACAATCTGCA-1	LowQuality
GAACCTACACCAGGCT-1	LowQuality
GAACCTACACGTGAGA-1	GoodQuality
GAACCTACAGTAAGAT-1	LowQuality
GAACCTACATCCTAGA-1	LowQuality
GAACCTACATCCTTGC-1	GoodQuality
GAACGGACACGACGAA-1	LowQuality
GAACGGAGTCGGATCC-1	GoodQuality
GAACGGAGTGACAAAT-1	GoodQuality
GAACGGATCAAGCCTA-1	GoodQuality
GAACGGATCCGTCAAA-1	GoodQuality
GAACGGATCGGAATCT-1	GoodQuality
GAAGCAGAGACTTGAA-1	GoodQuality
GAAGCAGAGAGTAATC-1	GoodQuality
GAAGCAGAGCGACGTA-1	GoodQuality
GAAGCAGAGCGGCTTC-1	LowQuality
GAAGCAGCAGACAAGC-1	GoodQuality
GAAGCAGCATGTTGAC-1	GoodQuality
GAAGCAGGTATGGTTC-1	GoodQuality
GAAGCAGTCATCGCTC-1	GoodQuality
GAAGCAGTCCCTCAGT-1	GoodQuality
GAAGCAGTCTTGAGAC-1	GoodQuality
GAATAAGAGAGGTAGA-1	LowQuality
GAATAAGAGCTGTTCA-1	GoodQuality
GAATAAGAGTGATCGG-1	GoodQuality
GAATAAGCAAGCGATG-1	GoodQuality
GAATAAGCAGCGATCC-1	LowQuality
GAATAAGCAGGGAGAG-1	GoodQuality
GAATAAGCATGGATGG-1	GoodQuality
GAATAAGCATGGGAAC-1	GoodQuality
GAATAAGGTAAACACA-1	LowQuality
GAATAAGGTCTGATTG-1	GoodQuality
GAATAAGGTCTTCGTC-1	LowQuality
GAATAAGGTGGGTCAA-1	GoodQuality
GAATAAGTCATGCAAC-1	GoodQuality
GAATAAGTCCTAGGGC-1	GoodQuality
GAATAAGTCGGATGGA-1	GoodQuality
GAATAAGTCTCTGTCG-1	GoodQuality
GAATGAAAGGTCGGAT-1	GoodQuality
GAATGAAAGTCAATAG-1	LowQuality
GAATGAAAGTCCTCCT-1	GoodQuality
GAATGAAAGTGCAAGC-1	GoodQuality
GAATGAACAGTAACGG-1	LowQuality
GAATGAAGTACTCAAC-1	LowQuality
GAATGAAGTCATCGGC-1	GoodQuality
GAATGAAGTCGAAAGC-1	GoodQuality
GAATGAAGTTCCCTTG-1	LowQuality
GACACGCAGGCATGGT-1	GoodQuality
GACACGCGTCTAGTCA-1	GoodQuality
GACACGCGTCTCCATC-1	GoodQuality
GACACGCGTGTGTGCC-1	GoodQuality
GACACGCTCACGACTA-1	LowQuality
GACACGCTCCATTCTA-1	LowQuality
GACACGCTCTCGCATC-1	LowQuality
GACAGAGAGCTCTCGG-1	GoodQuality
GACAGAGAGGCTCAGA-1	LowQuality
GACAGAGAGTGGGATC-1	GoodQuality
GACAGAGCATCTCCCA-1	GoodQuality
GACAGAGGTCAGCTAT-1	GoodQuality
GACAGAGGTGCCTGTG-1	GoodQuality
GACAGAGTCAGTGCAT-1	GoodQuality
GACAGAGTCATGCTCC-1	GoodQuality
GACAGAGTCCAATGGT-1	GoodQuality
GACAGAGTCTAACTCT-1	GoodQuality
GACCAATAGAATCTCC-1	GoodQuality
GACCAATAGAGACTTA-1	LowQuality
GACCAATCACTAGTAC-1	LowQuality
GACCAATGTAAAGGAG-1	GoodQuality
GACCAATGTTGTCGCG-1	LowQuality
GACCAATTCCGAGCCA-1	GoodQuality
GACCAATTCCTCGCAT-1	GoodQuality
GACCAATTCTTTAGTC-1	LowQuality
GACCTGGAGGCAATTA-1	GoodQuality
GACCTGGAGTGGACGT-1	GoodQuality
GACCTGGCAAGTCTAC-1	LowQuality
GACCTGGCACTATCTT-1	GoodQuality
GACCTGGCAGCGTTCG-1	GoodQuality
GACCTGGGTCAAAGAT-1	GoodQuality
GACCTGGTCCGCAAGC-1	GoodQuality
GACCTGGTCTGCTGCT-1	GoodQuality
GACCTGGTCTTTAGGG-1	LowQuality
GACGCGTAGTATGACA-1	LowQuality
GACGCGTCACAACTGT-1	LowQuality
GACGCGTGTGCACCAC-1	GoodQuality
GACGCGTGTTGAGTTC-1	GoodQuality
GACGCGTTCCTGTACC-1	GoodQuality
GACGCGTTCGGTCTAA-1	LowQuality
GACGGCTAGATCCGAG-1	LowQuality
GACGGCTAGCTAGTTC-1	LowQuality
GACGGCTAGGCCCTCA-1	GoodQuality
GACGGCTCACATTCGA-1	LowQuality
GACGGCTCACTACAGT-1	GoodQuality
GACGGCTCATATGAGA-1	LowQuality
GACGGCTCATGTAGTC-1	GoodQuality
GACGGCTGTATCAGTC-1	GoodQuality
GACGGCTGTCAAAGAT-1	GoodQuality
GACGGCTGTTCACGGC-1	GoodQuality
GACGGCTTCTGCGTAA-1	LowQuality
GACGTGCAGTACACCT-1	LowQuality
GACGTGCCAAACCTAC-1	GoodQuality
GACGTGCCAATGGAAT-1	GoodQuality
GACGTGCCACACGCTG-1	GoodQuality
GACGTGCCACGGTAAG-1	GoodQuality
GACGTGCGTACACCGC-1	GoodQuality
GACGTGCGTCGGATCC-1	GoodQuality
GACGTGCGTGACGCCT-1	GoodQuality
GACGTGCGTGAGGCTA-1	LowQuality
GACGTGCGTGGTTTCA-1	GoodQuality
GACGTGCGTTCACCTC-1	LowQuality
GACGTGCGTTTACTCT-1	GoodQuality
GACGTGCTCGGAAACG-1	GoodQuality
GACGTGCTCGTTTGCC-1	GoodQuality
GACGTTAAGAGTACCG-1	GoodQuality
GACGTTAAGTGTTTGC-1	GoodQuality
GACGTTACAAGTTAAG-1	GoodQuality
GACGTTACACAGAGGT-1	GoodQuality
GACGTTACACATAACC-1	GoodQuality
GACGTTACATCCCATC-1	GoodQuality
GACGTTAGTACATGTC-1	GoodQuality
GACGTTAGTCAGAGGT-1	GoodQuality
GACGTTAGTCGAATCT-1	GoodQuality
GACGTTAGTCTCACCT-1	GoodQuality
GACGTTAGTGAACCTT-1	GoodQuality
GACGTTATCCAGATCA-1	LowQuality
GACGTTATCCTTAATC-1	GoodQuality
GACGTTATCGCCATAA-1	LowQuality
GACGTTATCGCCCTTA-1	GoodQuality
GACTAACAGCGATCCC-1	GoodQuality
GACTAACAGTACACCT-1	GoodQuality
GACTAACAGTGAATTG-1	GoodQuality
GACTAACCACGAGGTA-1	LowQuality
GACTAACCAGATCTGT-1	GoodQuality
GACTAACGTACGCACC-1	GoodQuality
GACTAACGTATGGTTC-1	GoodQuality
GACTAACGTTAAAGAC-1	LowQuality
GACTAACTCCTTCAAT-1	GoodQuality
GACTAACTCCTTTCGG-1	LowQuality
GACTAACTCTCCCTGA-1	LowQuality
GACTAACTCTGCAGTA-1	GoodQuality
GACTAACTCTGCGTAA-1	LowQuality
GACTAACTCTGTCTCG-1	GoodQuality
GACTAACTCTGTTTGT-1	LowQuality
GACTACAAGCTGTTCA-1	LowQuality
GACTACAAGGTAGCCA-1	GoodQuality
GACTACAAGTACGCCC-1	GoodQuality
GACTACAAGTCACGCC-1	GoodQuality
GACTACACAATGGACG-1	LowQuality
GACTACAGTAAACGCG-1	LowQuality
GACTACAGTCAGAGGT-1	GoodQuality
GACTACAGTGACTACT-1	LowQuality
GACTACAGTGAGTGAC-1	GoodQuality
GACTACATCATGTGGT-1	GoodQuality
GACTACATCTCGTATT-1	GoodQuality
GACTGCGAGAAGGACA-1	GoodQuality
GACTGCGAGACAGACC-1	GoodQuality
GACTGCGAGCTCCCAG-1	GoodQuality
GACTGCGAGGCATGGT-1	LowQuality
GACTGCGCAGCATACT-1	GoodQuality
GACTGCGGTCAGAATA-1	GoodQuality
GACTGCGGTTTGACTG-1	GoodQuality
GACTGCGTCCGGCACA-1	GoodQuality
GACTGCGTCGAGAACG-1	GoodQuality
GACTGCGTCGGAATCT-1	LowQuality
GAGCAGAAGAGTTGGC-1	LowQuality
GAGCAGACAAACCTAC-1	GoodQuality
GAGCAGACATTCTTAC-1	LowQuality
GAGCAGATCTTTACAC-1	GoodQuality
GAGGTGACACAGACAG-1	LowQuality
GAGGTGACAGTGGGAT-1	GoodQuality
GAGGTGAGTGCACGAA-1	GoodQuality
GAGGTGATCAACACCA-1	LowQuality
GAGTCCGAGCCAGGAT-1	GoodQuality
GAGTCCGAGCTAGTTC-1	GoodQuality
GAGTCCGAGCTCTCGG-1	GoodQuality
GAGTCCGAGGCTACGA-1	LowQuality
GAGTCCGCACACATGT-1	GoodQuality
GAGTCCGCAGGTCGTC-1	GoodQuality
GAGTCCGCATCGACGC-1	LowQuality
GAGTCCGCATGCCACG-1	GoodQuality
GAGTCCGCATTCTCAT-1	GoodQuality
GAGTCCGGTAGCGATG-1	GoodQuality
GAGTCCGGTATATCCG-1	GoodQuality
GAGTCCGGTCCTGCTT-1	GoodQuality
GAGTCCGGTCTCACCT-1	LowQuality
GAGTCCGTCAAGCCTA-1	GoodQuality
GATCAGTAGATGCCTT-1	GoodQuality
GATCAGTAGTATCGAA-1	GoodQuality
GATCAGTCAGCTCGAC-1	GoodQuality
GATCAGTCATGTCGAT-1	LowQuality
GATCAGTGTCTAGTCA-1	GoodQuality
GATCAGTGTTGTTTGG-1	LowQuality
GATCAGTTCAACGAAA-1	LowQuality
GATCGATAGCCTATGT-1	GoodQuality
GATCGATAGCGAGAAA-1	GoodQuality
GATCGATCAAGCCTAT-1	GoodQuality
GATCGATCACAGACTT-1	GoodQuality
GATCGATCATATGCTG-1	GoodQuality
GATCGATCATCCTTGC-1	LowQuality
GATCGATGTCGCATCG-1	GoodQuality
GATCGATGTCTCCATC-1	LowQuality
GATCGCGAGAAAGTGG-1	GoodQuality
GATCGCGAGTACTTGC-1	GoodQuality
GATCGCGCAAGCGTAG-1	GoodQuality
GATCGCGCACATCCAA-1	LowQuality
GATCGCGGTACCGAGA-1	GoodQuality
GATCGCGGTCGTTGTA-1	LowQuality
GATCGCGGTCTCCACT-1	LowQuality
GATCGCGTCTCCAGGG-1	LowQuality
GATCGCGTCTGCAGTA-1	GoodQuality
GATCGTAAGCGATCCC-1	GoodQuality
GATCGTAAGGAATTAC-1	LowQuality
GATCGTAAGTACGCCC-1	LowQuality
GATCGTAAGTTGTAGA-1	LowQuality
GATCGTACAGATGAGC-1	GoodQuality
GATCGTACAGTAAGCG-1	LowQuality
GATCGTAGTCGCTTCT-1	GoodQuality
GATCGTAGTGGTCTCG-1	GoodQuality
GATCGTATCAATCTCT-1	LowQuality
GATCGTATCAGCATGT-1	LowQuality
GATCGTATCTCGTATT-1	GoodQuality
GATCTAGAGCTAGTCT-1	GoodQuality
GATCTAGAGGAATTAC-1	GoodQuality
GATCTAGAGGAGTTTA-1	LowQuality
GATCTAGCACCCATGG-1	GoodQuality
GATCTAGCACGCGAAA-1	LowQuality
GATCTAGCATAACCTG-1	GoodQuality
GATCTAGGTCCTAGCG-1	GoodQuality
GATCTAGTCAAACGGG-1	GoodQuality
GATCTAGTCCGCAAGC-1	GoodQuality
GATCTAGTCTTGAGGT-1	GoodQuality
GATGAAAAGAAACGAG-1	GoodQuality
GATGAAAAGAGGTACC-1	GoodQuality
GATGAAAAGCTACCTA-1	GoodQuality
GATGAAAAGCTTTGGT-1	GoodQuality
GATGAAAAGTCATGCT-1	GoodQuality
GATGAAAAGTTCCACA-1	GoodQuality
GATGAAACACCAGCAC-1	GoodQuality
GATGAAACACTCAGGC-1	GoodQuality
GATGAAACATGGATGG-1	GoodQuality
GATGAAACATTTGCCC-1	GoodQuality
GATGAAAGTCATACTG-1	LowQuality
GATGAAAGTCCAGTGC-1	GoodQuality
GATGAAAGTCTCCACT-1	LowQuality
GATGAAAGTGCATCTA-1	GoodQuality
GATGAAAGTGGTGTAG-1	LowQuality
GATGAAAGTTGTCTTT-1	LowQuality
GATGAAATCAACCAAC-1	LowQuality
GATGAAATCCTTGCCA-1	GoodQuality
GATGAAATCTAACTGG-1	GoodQuality
GATGAGGAGATCCCGC-1	GoodQuality
GATGAGGAGGACAGAA-1	LowQuality
GATGAGGCAATGGAAT-1	GoodQuality
GATGAGGCAATGGACG-1	GoodQuality
GATGAGGCACTTGGAT-1	GoodQuality
GATGAGGCAGCTGCTG-1	GoodQuality
GATGAGGGTATGCTTG-1	GoodQuality
GATGAGGGTCAGCTAT-1	GoodQuality
GATGAGGGTCGACTAT-1	GoodQuality
GATGAGGGTCGAGTTT-1	LowQuality
GATGAGGGTTCAGTAC-1	LowQuality
GATGAGGTCGCTGATA-1	GoodQuality
GATGAGGTCTTGTCAT-1	GoodQuality
GATGCTAAGCTAACAA-1	GoodQuality
GATGCTAAGGAATCGC-1	GoodQuality
GATGCTAAGTCCCACG-1	GoodQuality
GATGCTACAAAGTGCG-1	LowQuality
GATGCTACAATGGAAT-1	LowQuality
GATGCTACAGTCAGAG-1	GoodQuality
GATGCTACAGTGAGTG-1	GoodQuality
GATGCTAGTTCGTTGA-1	LowQuality
GATGCTATCAACCAAC-1	LowQuality
GATGCTATCACATACG-1	GoodQuality
GATGCTATCGGTGTTA-1	LowQuality
GATTCAGAGAAGCCCA-1	GoodQuality
GATTCAGAGACAAGCC-1	GoodQuality
GATTCAGAGACAGAGA-1	GoodQuality
GATTCAGAGATGTAAC-1	GoodQuality
GATTCAGAGCGCTTAT-1	LowQuality
GATTCAGAGGCCCTTG-1	LowQuality
GATTCAGAGTTGTCGT-1	LowQuality
GATTCAGCACATCCGG-1	GoodQuality
GATTCAGCACCGCTAG-1	LowQuality
GATTCAGCACGCTTTC-1	GoodQuality
GATTCAGCATGACATC-1	GoodQuality
GATTCAGGTAACGCGA-1	LowQuality
GATTCAGGTTTGTTGG-1	LowQuality
GATTCAGTCCTTTACA-1	LowQuality
GATTCAGTCTCGAGTA-1	GoodQuality
GCAAACTAGACCTTTG-1	GoodQuality
GCAAACTAGATGTAAC-1	LowQuality
GCAAACTAGGCGACAT-1	GoodQuality
GCAAACTAGGGTCGAT-1	LowQuality
GCAAACTCAGGGCATA-1	GoodQuality
GCAAACTCATGCCTTC-1	GoodQuality
GCAAACTGTCTGATCA-1	LowQuality
GCAAACTGTGTGAAAT-1	GoodQuality
GCAAACTGTGTGTGCC-1	GoodQuality
GCAAACTTCAGTACGT-1	GoodQuality
GCAAACTTCATTATCC-1	GoodQuality
GCAATCAAGAAAGTGG-1	LowQuality
GCAATCAAGACTGTAA-1	LowQuality
GCAATCAAGCAATATG-1	LowQuality
GCAATCAAGTACGACG-1	LowQuality
GCAATCAAGTCTCCTC-1	GoodQuality
GCAATCAAGTTTCCTT-1	GoodQuality
GCAATCACAACGCACC-1	GoodQuality
GCAATCAGTAGCGATG-1	LowQuality
GCAATCAGTAGCGTAG-1	LowQuality
GCAATCAGTCGGCACT-1	LowQuality
GCAATCAGTTCTGAAC-1	GoodQuality
GCAATCAGTTGTCTTT-1	GoodQuality
GCAATCATCCTCCTAG-1	GoodQuality
GCACATAAGACACTAA-1	GoodQuality
GCACATAAGCACACAG-1	GoodQuality
GCACATAAGGTGCAAC-1	GoodQuality
GCACATAAGTGGCACA-1	LowQuality
GCACATACAGAGTGTG-1	LowQuality
GCACATACAGGGCATA-1	LowQuality
GCACATACATCCAACA-1	LowQuality
GCACATAGTCAGAATA-1	GoodQuality
GCACATAGTCTAAAGA-1	LowQuality
GCACATAGTGAGTGAC-1	GoodQuality
GCACATATCACGACTA-1	GoodQuality
GCACTCTAGCAAATCA-1	GoodQuality
GCACTCTAGCGAAGGG-1	GoodQuality
GCACTCTAGCTCTCGG-1	GoodQuality
GCACTCTAGGCGACAT-1	GoodQuality
GCACTCTCAGCCTTTC-1	LowQuality
GCACTCTCAGGAATCG-1	GoodQuality
GCACTCTCATTCTTAC-1	GoodQuality
GCACTCTGTAACGTTC-1	LowQuality
GCACTCTGTTCTGAAC-1	GoodQuality
GCACTCTTCAGTCCCT-1	GoodQuality
GCACTCTTCCTAGGGC-1	GoodQuality
GCACTCTTCGTCTGCT-1	GoodQuality
GCACTCTTCTGAAAGA-1	GoodQuality
GCAGCCAAGACACTAA-1	LowQuality
GCAGCCAAGGCAATTA-1	LowQuality
GCAGCCACAATCTACG-1	GoodQuality
GCAGCCACACTAGTAC-1	LowQuality
GCAGCCACAGGCAGTA-1	GoodQuality
GCAGCCACATACGCTA-1	LowQuality
GCAGCCACATAGGATA-1	GoodQuality
GCAGCCACATTACGAC-1	LowQuality
GCAGCCAGTCTACCTC-1	LowQuality
GCAGCCATCATATCGG-1	LowQuality
GCAGCCATCCTTGGTC-1	GoodQuality
GCAGCCATCGTTACAG-1	GoodQuality
GCAGTTAAGGTGATAT-1	LowQuality
GCAGTTAAGTACTTGC-1	LowQuality
GCAGTTAGTACAGACG-1	GoodQuality
GCAGTTAGTAGCCTAT-1	LowQuality
GCAGTTAGTCTCTCTG-1	GoodQuality
GCAGTTAGTGTGCCTG-1	GoodQuality
GCAGTTAGTGTTTGGT-1	GoodQuality
GCAGTTAGTTGTCGCG-1	GoodQuality
GCAGTTATCCTTGACC-1	GoodQuality
GCAGTTATCTGTCAAG-1	GoodQuality
GCATACAAGCCCGAAA-1	GoodQuality
GCATACAAGGCGATAC-1	LowQuality
GCATACAAGGTGCAAC-1	LowQuality
GCATACAAGTAGGTGC-1	LowQuality
GCATACAAGTTACGGG-1	GoodQuality
GCATACACACAACGCC-1	GoodQuality
GCATACACACAGGAGT-1	GoodQuality
GCATACACACATTCGA-1	LowQuality
GCATACAGTGAAGGCT-1	GoodQuality
GCATACATCAACGAAA-1	GoodQuality
GCATACATCACCTCGT-1	GoodQuality
GCATACATCTGCGACG-1	GoodQuality
GCATGATAGACGCAAC-1	LowQuality
GCATGATAGATGGGTC-1	LowQuality
GCATGATAGTAGGCCA-1	LowQuality
GCATGATAGTCCGGTC-1	GoodQuality
GCATGATCAATGGACG-1	LowQuality
GCATGATCACATGACT-1	GoodQuality
GCATGATCACCACCAG-1	GoodQuality
GCATGATGTCGGATCC-1	GoodQuality
GCATGATGTCGGCATC-1	GoodQuality
GCATGATGTTACAGAA-1	LowQuality
GCATGATTCAATCTCT-1	GoodQuality
GCATGCGCACATCCAA-1	LowQuality
GCATGCGGTACAGCAG-1	GoodQuality
GCATGCGGTGCCTGGT-1	LowQuality
GCATGCGTCACGAAGG-1	GoodQuality
GCATGCGTCCACGAAT-1	GoodQuality
GCATGCGTCTCTGCTG-1	GoodQuality
GCATGCGTCTTGAGAC-1	GoodQuality
GCATGTAAGACGCAAC-1	GoodQuality
GCATGTAAGACGCTTT-1	GoodQuality
GCATGTAAGTCTCCTC-1	GoodQuality
GCATGTAGTGGCTCCA-1	GoodQuality
GCATGTATCAAACCGT-1	LowQuality
GCATGTATCCTCTAGC-1	LowQuality
GCATGTATCGTAGGAG-1	LowQuality
GCCAAATAGCGCTTAT-1	GoodQuality
GCCAAATAGGACCACA-1	GoodQuality
GCCAAATGTAACGTTC-1	LowQuality
GCCAAATGTACACCGC-1	GoodQuality
GCCAAATGTCTGATTG-1	LowQuality
GCCAAATGTGCAGGTA-1	GoodQuality
GCCAAATTCACATGCA-1	LowQuality
GCCAAATTCATGTCCC-1	GoodQuality
GCCAAATTCTGCGACG-1	GoodQuality
GCCTCTAAGAGCTGCA-1	LowQuality
GCCTCTAAGCCGCCTA-1	GoodQuality
GCCTCTACAGGTTTCA-1	GoodQuality
GCCTCTAGTGCACCAC-1	GoodQuality
GCCTCTATCCTCAACC-1	GoodQuality
GCCTCTATCGCCTGTT-1	GoodQuality
GCCTCTATCTTGCCGT-1	GoodQuality
GCGACCAAGCGGATCA-1	LowQuality
GCGACCAAGTCTCCTC-1	GoodQuality
GCGACCACACGTCTCT-1	LowQuality
GCGACCAGTCGCTTCT-1	LowQuality
GCGACCAGTTTACTCT-1	GoodQuality
GCGACCATCAACCATG-1	LowQuality
GCGACCATCCCAAGTA-1	GoodQuality
GCGACCATCCGCATAA-1	GoodQuality
GCGACCATCGCTAGCG-1	GoodQuality
GCGAGAAAGAAGGCCT-1	LowQuality
GCGAGAAAGAGGGCTT-1	GoodQuality
GCGAGAACAAGTCTGT-1	LowQuality
GCGAGAACAATTCCTT-1	GoodQuality
GCGAGAACACGTGAGA-1	GoodQuality
GCGAGAACAGTCAGCC-1	GoodQuality
GCGAGAAGTAGCGTGA-1	GoodQuality
GCGAGAAGTCTAGTGT-1	LowQuality
GCGAGAAGTGACGGTA-1	LowQuality
GCGAGAAGTTTGACTG-1	GoodQuality
GCGAGAATCAACGGGA-1	GoodQuality
GCGAGAATCCGTAGTA-1	GoodQuality
GCGCAACAGAACTCGG-1	LowQuality
GCGCAACAGAGTACCG-1	GoodQuality
GCGCAACAGGCTAGGT-1	LowQuality
GCGCAACAGTACGACG-1	LowQuality
GCGCAACAGTATCTCG-1	GoodQuality
GCGCAACAGTGGACGT-1	GoodQuality
GCGCAACCAATAGCAA-1	GoodQuality
GCGCAACCACTGAAGG-1	LowQuality
GCGCAACGTATGAATG-1	GoodQuality
GCGCAACGTCTCTCGT-1	GoodQuality
GCGCAACGTCTGATTG-1	GoodQuality
GCGCAACGTTTAAGCC-1	GoodQuality
GCGCAACTCACCAGGC-1	GoodQuality
GCGCAACTCAGCACAT-1	GoodQuality
GCGCAACTCGCAAGCC-1	LowQuality
GCGCAACTCGGTCTAA-1	GoodQuality
GCGCAGTCAAGAGGCT-1	GoodQuality
GCGCAGTCAAGCTGTT-1	LowQuality
GCGCAGTCACCAGCAC-1	GoodQuality
GCGCAGTGTAACGACG-1	GoodQuality
GCGCAGTGTCCGAGTC-1	LowQuality
GCGCAGTTCACGAAGG-1	GoodQuality
GCGCAGTTCCAAATGC-1	LowQuality
GCGCAGTTCCGTTGCT-1	LowQuality
GCGCAGTTCTGCTTGC-1	LowQuality
GCGCCAAAGCTAGTTC-1	LowQuality
GCGCCAAAGTGTACGG-1	GoodQuality
GCGCCAACAACAACCT-1	GoodQuality
GCGCCAAGTATAGGTA-1	GoodQuality
GCGCCAAGTCGCGAAA-1	GoodQuality
GCGCCAATCATTCACT-1	GoodQuality
GCGCCAATCCCGACTT-1	GoodQuality
GCGCCAATCCGGCACA-1	GoodQuality
GCGCGATAGCGTCAAG-1	LowQuality
GCGCGATAGGCTATCT-1	LowQuality
GCGCGATAGTGTCTCA-1	LowQuality
GCGCGATCAGATCGGA-1	GoodQuality
GCGCGATCAGATGGGT-1	GoodQuality
GCGCGATCATACTACG-1	GoodQuality
GCGCGATGTAAAGTCA-1	GoodQuality
GCGCGATGTCTGCCAG-1	LowQuality
GCGCGATTCCAATGGT-1	GoodQuality
GCGCGATTCTTATCTG-1	LowQuality
GCGGGTTAGAAGCCCA-1	GoodQuality
GCGGGTTAGCCAGGAT-1	LowQuality
GCGGGTTAGCCCAGCT-1	LowQuality
GCGGGTTAGCGTTGCC-1	LowQuality
GCGGGTTAGCTCAACT-1	LowQuality
GCGGGTTCACCATCCT-1	GoodQuality
GCGGGTTCACTAAGTC-1	GoodQuality
GCGGGTTCATCGACGC-1	GoodQuality
GCGGGTTGTGTGAATA-1	GoodQuality
GCGGGTTGTTGGACCC-1	GoodQuality
GCGGGTTTCTGGAGCC-1	LowQuality
GCTCCTAAGGCAGGTT-1	LowQuality
GCTCCTAAGTCAATAG-1	GoodQuality
GCTCCTAAGTCTCCTC-1	LowQuality
GCTCCTACAAATTGCC-1	GoodQuality
GCTCCTAGTCTTGCGG-1	LowQuality
GCTCCTATCACTGGGC-1	GoodQuality
GCTCCTATCAGGTTCA-1	GoodQuality
GCTCCTATCCGCATCT-1	GoodQuality
GCTCCTATCCTAGTGA-1	LowQuality
GCTCCTATCTCTGAGA-1	GoodQuality
GCTCTGTAGCGTTGCC-1	GoodQuality
GCTCTGTAGCTGCGAA-1	GoodQuality
GCTCTGTAGGACACCA-1	GoodQuality
GCTCTGTAGGCCCTCA-1	LowQuality
GCTCTGTAGGTGCACA-1	LowQuality
GCTCTGTCAACACCCG-1	LowQuality
GCTCTGTCAATAGCAA-1	LowQuality
GCTCTGTCACACATGT-1	LowQuality
GCTCTGTCAGATCGGA-1	GoodQuality
GCTCTGTCATGCCACG-1	GoodQuality
GCTCTGTTCACTCCTG-1	GoodQuality
GCTCTGTTCTCGGACG-1	LowQuality
GCTCTGTTCTCTTGAT-1	GoodQuality
GCTCTGTTCTGGCGAC-1	GoodQuality
GCTCTGTTCTGTCTCG-1	GoodQuality
GCTGCAGAGCCTCGTG-1	GoodQuality
GCTGCAGAGCGATAGC-1	LowQuality
GCTGCAGAGCGATCCC-1	GoodQuality
GCTGCAGAGGGATACC-1	GoodQuality
GCTGCAGCAAGACGTG-1	GoodQuality
GCTGCAGCACGAAACG-1	GoodQuality
GCTGCAGCACGGCTAC-1	GoodQuality
GCTGCAGCAGATGAGC-1	GoodQuality
GCTGCAGGTATGCTTG-1	GoodQuality
GCTGCAGGTCAATGTC-1	LowQuality
GCTGCAGGTCCAGTTA-1	GoodQuality
GCTGCAGTCACTCCTG-1	GoodQuality
GCTGCAGTCATGGTCA-1	GoodQuality
GCTGCGAAGACCGGAT-1	GoodQuality
GCTGCGAAGAGCTGGT-1	GoodQuality
GCTGCGACAAGCGAGT-1	LowQuality
GCTGCGACACACCGAC-1	GoodQuality
GCTGCGACACCGAAAG-1	GoodQuality
GCTGCGACATCTCGCT-1	GoodQuality
GCTGCGATCCAAACTG-1	GoodQuality
GCTGCGATCGTACCGG-1	LowQuality
GCTGCGATCTTAGAGC-1	GoodQuality
GCTGCTTAGTGCAAGC-1	GoodQuality
GCTGCTTCAAGCGAGT-1	GoodQuality
GCTGCTTCACATGGGA-1	GoodQuality
GCTGCTTCACGGCGTT-1	LowQuality
GCTGCTTGTAAGTGTA-1	GoodQuality
GCTGCTTGTCAATACC-1	GoodQuality
GCTGCTTGTCGAACAG-1	LowQuality
GCTGCTTGTTAAGAAC-1	GoodQuality
GCTGCTTTCCTTAATC-1	GoodQuality
GCTGGGTCACAAGCCC-1	GoodQuality
GCTGGGTCAGTGACAG-1	GoodQuality
GCTGGGTGTCCGAAGA-1	GoodQuality
GCTGGGTGTCGCTTTC-1	LowQuality
GCTGGGTGTTCAGTAC-1	GoodQuality
GCTGGGTTCAGCTTAG-1	LowQuality
GCTGGGTTCATCATTC-1	GoodQuality
GCTGGGTTCGGGAGTA-1	GoodQuality
GCTTCCAAGCTAGCCC-1	GoodQuality
GCTTCCAAGTTTCCTT-1	GoodQuality
GCTTCCACAAGTAGTA-1	GoodQuality
GCTTCCACAGACGCAA-1	GoodQuality
GCTTCCACAGTCGTGC-1	GoodQuality
GCTTCCACAGTTTACG-1	GoodQuality
GCTTCCACATGAAGTA-1	GoodQuality
GCTTCCAGTAGCCTAT-1	GoodQuality
GCTTCCAGTCAATGTC-1	GoodQuality
GCTTCCATCATGTCTT-1	LowQuality
GCTTCCATCCCTCAGT-1	GoodQuality
GCTTCCATCCTTGGTC-1	GoodQuality
GCTTCCATCGGCATCG-1	GoodQuality
GCTTGAAAGAGAGCTC-1	GoodQuality
GCTTGAAAGAGTGAGA-1	GoodQuality
GCTTGAAAGTACGATA-1	GoodQuality
GCTTGAACAAGCGTAG-1	GoodQuality
GCTTGAACACATGACT-1	LowQuality
GCTTGAACACATGGGA-1	LowQuality
GCTTGAACAGATCGGA-1	GoodQuality
GCTTGAACATATACCG-1	GoodQuality
GCTTGAACATTGCGGC-1	GoodQuality
GCTTGAAGTACCGGCT-1	LowQuality
GCTTGAAGTACGACCC-1	LowQuality
GCTTGAATCACTGGGC-1	GoodQuality
GCTTGAATCCGTAGGC-1	GoodQuality
GCTTGAATCCTTGGTC-1	GoodQuality
GGAAAGCAGCGGATCA-1	GoodQuality
GGAAAGCAGTATCGAA-1	LowQuality
GGAAAGCCAAGAGGCT-1	LowQuality
GGAAAGCGTCATACTG-1	LowQuality
GGAAAGCTCATCGGAT-1	LowQuality
GGAAAGCTCGCGTTTC-1	GoodQuality
GGAACTTAGGGAGTAA-1	LowQuality
GGAACTTAGTAGTGCG-1	GoodQuality
GGAACTTCAGCTATTG-1	GoodQuality
GGAACTTCAGTGGGAT-1	GoodQuality
GGAACTTGTCCAGTTA-1	GoodQuality
GGAACTTTCGCCTGAG-1	GoodQuality
GGAACTTTCTATCCCG-1	GoodQuality
GGAATAAAGAAACCGC-1	GoodQuality
GGAATAAAGAAGAAGC-1	LowQuality
GGAATAAAGATAGGAG-1	GoodQuality
GGAATAACATAAAGGT-1	GoodQuality
GGAATAAGTAAACCTC-1	GoodQuality
GGAATAAGTAGGGACT-1	GoodQuality
GGAATAAGTGTTAAGA-1	GoodQuality
GGAATAAGTTCCACGG-1	GoodQuality
GGAATAATCAAACGGG-1	GoodQuality
GGAATAATCTGTTGAG-1	GoodQuality
GGAATAATCTTTAGTC-1	GoodQuality
GGACAAGAGACTCGGA-1	GoodQuality
GGACAAGAGAGGGATA-1	LowQuality
GGACAAGAGGTGATAT-1	LowQuality
GGACAAGCAGACGTAG-1	LowQuality
GGACAAGCAGTCGTGC-1	GoodQuality
GGACAAGCATCCGGGT-1	GoodQuality
GGACAAGGTGTTGAGG-1	GoodQuality
GGACAAGTCGCACTCT-1	GoodQuality
GGACAAGTCTGCTGCT-1	LowQuality
GGACAAGTCTGGTTCC-1	GoodQuality
GGACAAGTCTGTTTGT-1	GoodQuality
GGACAGAAGACTGGGT-1	GoodQuality
GGACAGAAGCTAGCCC-1	GoodQuality
GGACAGACAGGCAGTA-1	GoodQuality
GGACAGACATCCTTGC-1	LowQuality
GGACAGACATGTCGAT-1	GoodQuality
GGACAGAGTGTAATGA-1	GoodQuality
GGACAGAGTTAAGACA-1	LowQuality
GGACAGAGTTCCACTC-1	GoodQuality
GGACAGAGTTCCATGA-1	GoodQuality
GGACAGAGTTGTCTTT-1	LowQuality
GGACATTAGATCCCGC-1	GoodQuality
GGACATTAGTTCGATC-1	GoodQuality
GGACATTCAATGGATA-1	GoodQuality
GGACATTCACATCTTT-1	GoodQuality
GGACATTGTTCCACTC-1	GoodQuality
GGACATTTCAACGGGA-1	GoodQuality
GGACATTTCACGCATA-1	GoodQuality
GGACGTCAGACTGTAA-1	LowQuality
GGACGTCAGTAGTGCG-1	GoodQuality
GGACGTCCAAACCTAC-1	GoodQuality
GGACGTCCAGGGATTG-1	LowQuality
GGACGTCCATGGATGG-1	LowQuality
GGACGTCGTAAACCTC-1	LowQuality
GGACGTCGTACTTGAC-1	GoodQuality
GGACGTCGTAGCGTCC-1	LowQuality
GGACGTCGTCAACATC-1	LowQuality
GGACGTCTCATTGCCC-1	GoodQuality
GGACGTCTCCTCCTAG-1	LowQuality
GGACGTCTCGGAGCAA-1	GoodQuality
GGACGTCTCTGCAGTA-1	GoodQuality
GGAGCAACACCAGGCT-1	GoodQuality
GGAGCAACAGGTCGTC-1	GoodQuality
GGAGCAACATATACGC-1	LowQuality
GGAGCAACATCAGTAC-1	GoodQuality
GGAGCAACATGGTTGT-1	GoodQuality
GGAGCAAGTAGTGAAT-1	GoodQuality
GGAGCAAGTGACGCCT-1	GoodQuality
GGAGCAAGTGAGGGAG-1	GoodQuality
GGAGCAAGTGTCCTCT-1	GoodQuality
GGAGCAAGTTGCCTCT-1	GoodQuality
GGAGCAATCGTGGGAA-1	GoodQuality
GGAGCAATCTATCGCC-1	LowQuality
GGATGTTAGACCACGA-1	GoodQuality
GGATGTTCACAGCGTC-1	GoodQuality
GGATGTTGTAAGCACG-1	GoodQuality
GGATGTTGTGACAAAT-1	GoodQuality
GGATGTTGTGAGCGAT-1	GoodQuality
GGATGTTTCAAACGGG-1	LowQuality
GGATGTTTCCACGTTC-1	GoodQuality
GGATGTTTCCAGATCA-1	GoodQuality
GGATGTTTCCGCGCAA-1	GoodQuality
GGATGTTTCCTCCTAG-1	GoodQuality
GGATGTTTCTCTAAGG-1	GoodQuality
GGATTACAGAGTCGGT-1	GoodQuality
GGATTACAGCGGCTTC-1	GoodQuality
GGATTACAGTACGTTC-1	GoodQuality
GGATTACCACATGACT-1	GoodQuality
GGATTACCACCATCCT-1	GoodQuality
GGATTACCAGCTGCAC-1	GoodQuality
GGATTACCAGGTCGTC-1	GoodQuality
GGATTACCATTAGCCA-1	GoodQuality
GGCAATTAGAGCTATA-1	GoodQuality
GGCAATTAGATCACGG-1	GoodQuality
GGCAATTAGCAGATCG-1	GoodQuality
GGCAATTAGCTGCAAG-1	GoodQuality
GGCAATTAGGAGCGTT-1	LowQuality
GGCAATTCAAACTGCT-1	GoodQuality
GGCAATTCAAAGCAAT-1	GoodQuality
GGCAATTTCAACACTG-1	LowQuality
GGCAATTTCCAAGCCG-1	GoodQuality
GGCAATTTCCACGTGG-1	GoodQuality
GGCAATTTCCAGAAGG-1	GoodQuality
GGCAATTTCCTGCTTG-1	GoodQuality
GGCAATTTCGCAAACT-1	GoodQuality
GGCAATTTCGGCGCTA-1	GoodQuality
GGCCGATAGAATGTTG-1	GoodQuality
GGCCGATAGAGACTTA-1	GoodQuality
GGCCGATAGAGTAAGG-1	GoodQuality
GGCCGATCACGGTAGA-1	GoodQuality
GGCCGATCAGATCTGT-1	GoodQuality
GGCCGATCAGTCTTCC-1	LowQuality
GGCCGATGTACCGAGA-1	GoodQuality
GGCCGATGTATATGAG-1	GoodQuality
GGCCGATTCACTCCTG-1	GoodQuality
GGCCGATTCATTGCCC-1	GoodQuality
GGCCGATTCCACGTTC-1	GoodQuality
GGCCGATTCCGTAGTA-1	GoodQuality
GGCGACTAGCCAACAG-1	GoodQuality
GGCGACTAGCCGATTT-1	GoodQuality
GGCGACTAGCTGTCTA-1	GoodQuality
GGCGACTAGGTGCACA-1	GoodQuality
GGCGACTCAGCAGTTT-1	LowQuality
GGCGACTCAGTTTACG-1	GoodQuality
GGCGACTCATCTATGG-1	GoodQuality
GGCGACTGTACAGACG-1	GoodQuality
GGCGACTGTCCATCCT-1	LowQuality
GGCGACTGTCGCTTCT-1	GoodQuality
GGCGACTGTGACTACT-1	LowQuality
GGCGACTGTTAAGATG-1	GoodQuality
GGCGACTGTTCCACTC-1	LowQuality
GGCGACTTCACTCTTA-1	GoodQuality
GGCGACTTCGCCTGTT-1	GoodQuality
GGCGACTTCTAAGCCA-1	LowQuality
GGCGACTTCTCGTATT-1	GoodQuality
GGCGACTTCTTCCTTC-1	GoodQuality
GGCGTGTAGGAATGGA-1	GoodQuality
GGCGTGTAGTAGGTGC-1	GoodQuality
GGCGTGTGTTACGACT-1	LowQuality
GGCGTGTTCAACCAAC-1	GoodQuality
GGCGTGTTCAATAAGG-1	GoodQuality
GGCGTGTTCTGAGGGA-1	GoodQuality
GGCTCGAAGAATAGGG-1	GoodQuality
GGCTCGACATCACAAC-1	GoodQuality
GGCTCGAGTAAGTGTA-1	GoodQuality
GGCTCGAGTACTTCTT-1	LowQuality
GGCTCGAGTATATCCG-1	LowQuality
GGCTCGAGTGTATGGG-1	GoodQuality
GGCTCGAGTGTTTGGT-1	LowQuality
GGCTCGATCGATGAGG-1	LowQuality
GGCTCGATCGTACCGG-1	LowQuality
GGCTGGTCAGCTGTAT-1	LowQuality
GGCTGGTCATGTAGTC-1	GoodQuality
GGCTGGTGTATAGGTA-1	GoodQuality
GGCTGGTGTGCATCTA-1	LowQuality
GGCTGGTGTGCGCTTG-1	LowQuality
GGCTGGTGTGTCGCTG-1	GoodQuality
GGCTGGTTCACCCGAG-1	LowQuality
GGCTGGTTCCCAAGAT-1	GoodQuality
GGCTGGTTCCGTACAA-1	GoodQuality
GGGAATGAGGGTCGAT-1	LowQuality
GGGAATGAGTTGCAGG-1	GoodQuality
GGGAATGCAGACAAGC-1	GoodQuality
GGGAATGCAGACGTAG-1	GoodQuality
GGGAATGCATGGTAGG-1	GoodQuality
GGGAATGGTCAAAGAT-1	LowQuality
GGGAATGGTCAGCTAT-1	GoodQuality
GGGAATGGTTACGGAG-1	GoodQuality
GGGAATGTCAACCAAC-1	GoodQuality
GGGAATGTCCTTCAAT-1	GoodQuality
GGGAATGTCTCCTATA-1	LowQuality
GGGAATGTCTGTCTAT-1	LowQuality
GGGACCTAGAGTACAT-1	LowQuality
GGGACCTAGGATGGAA-1	LowQuality
GGGACCTAGGCACATG-1	LowQuality
GGGACCTCAATAGCAA-1	LowQuality
GGGACCTCACGAAGCA-1	GoodQuality
GGGACCTCAGGACGTA-1	LowQuality
GGGACCTGTCGCATCG-1	GoodQuality
GGGACCTTCCCTCTTT-1	LowQuality
GGGACCTTCCGTCAAA-1	GoodQuality
GGGACCTTCTCCGGTT-1	GoodQuality
GGGACCTTCTGATACG-1	GoodQuality
GGGACCTTCTTGAGGT-1	GoodQuality
GGGAGATAGAGTACCG-1	GoodQuality
GGGAGATAGATCGATA-1	LowQuality
GGGAGATAGCGAAGGG-1	GoodQuality
GGGAGATAGGCGTACA-1	GoodQuality
GGGAGATCAGTGGAGT-1	GoodQuality
GGGAGATGTGCAGACA-1	GoodQuality
GGGAGATGTTTGGGCC-1	GoodQuality
GGGAGATTCACATAGC-1	GoodQuality
GGGAGATTCAGGTTCA-1	GoodQuality
GGGAGATTCGGATGTT-1	GoodQuality
GGGATGAAGCTGAACG-1	GoodQuality
GGGATGAGTAAACGCG-1	GoodQuality
GGGATGAGTCCGTCAG-1	GoodQuality
GGGATGAGTCGAAAGC-1	GoodQuality
GGGATGATCTAGAGTC-1	LowQuality
GGGCACTAGAAGGGTA-1	GoodQuality
GGGCACTAGACATAAC-1	GoodQuality
GGGCACTAGGCATGTG-1	LowQuality
GGGCACTAGTACACCT-1	GoodQuality
GGGCACTAGTCAATAG-1	LowQuality
GGGCACTCAGCTCGCA-1	LowQuality
GGGCACTCAGCTGCTG-1	GoodQuality
GGGCACTGTGCACTTA-1	GoodQuality
GGGCACTGTTAGGGTG-1	LowQuality
GGGCACTTCAAACCGT-1	GoodQuality
GGGCACTTCAGGCGAA-1	GoodQuality
GGGCACTTCCATTCTA-1	GoodQuality
GGGCATCAGAGTGAGA-1	GoodQuality
GGGCATCAGCGTTTAC-1	GoodQuality
GGGCATCAGCTATGCT-1	GoodQuality
GGGCATCAGGGTGTGT-1	LowQuality
GGGCATCAGTGAAGAG-1	LowQuality
GGGCATCAGTGGGTTG-1	GoodQuality
GGGCATCCAGACGCTC-1	GoodQuality
GGGCATCCAGGACCCT-1	LowQuality
GGGCATCGTCGTGGCT-1	GoodQuality
GGGCATCGTGGGTATG-1	GoodQuality
GGGCATCGTTCGGCAC-1	GoodQuality
GGGCATCTCAAGGCTT-1	LowQuality
GGGCATCTCCCTAACC-1	GoodQuality
GGGCATCTCCGCATAA-1	GoodQuality
GGGCATCTCCTATTCA-1	GoodQuality
GGGTCTGAGCCTATGT-1	LowQuality
GGGTCTGAGGGCTTGA-1	GoodQuality
GGGTCTGCATCACGTA-1	LowQuality
GGGTCTGTCAAACAAG-1	GoodQuality
GGGTCTGTCACTTATC-1	LowQuality
GGGTCTGTCATTCACT-1	GoodQuality
GGGTCTGTCGTTACGA-1	GoodQuality
GGGTCTGTCTCTGAGA-1	LowQuality
GGGTTGCAGACATAAC-1	LowQuality
GGGTTGCAGCCATCGC-1	GoodQuality
GGGTTGCAGGAGTACC-1	GoodQuality
GGGTTGCAGGGTGTGT-1	GoodQuality
GGGTTGCCACAGCCCA-1	GoodQuality
GGGTTGCCATCACAAC-1	LowQuality
GGGTTGCCATCTCGCT-1	LowQuality
GGGTTGCGTCTCTTAT-1	GoodQuality
GGGTTGCTCCGTTGTC-1	LowQuality
GGTATTGAGATGGGTC-1	GoodQuality
GGTATTGAGTTAGCGG-1	GoodQuality
GGTATTGCACCGATAT-1	GoodQuality
GGTATTGCATCGATTG-1	LowQuality
GGTATTGCATTTGCTT-1	LowQuality
GGTATTGGTAAATGAC-1	GoodQuality
GGTATTGGTCAGAGGT-1	GoodQuality
GGTATTGGTCATTAGC-1	LowQuality
GGTATTGGTGTTCGAT-1	GoodQuality
GGTATTGTCCACGACG-1	GoodQuality
GGTATTGTCGAACTGT-1	LowQuality
GGTGAAGAGCTGCCCA-1	GoodQuality
GGTGAAGAGTCAATAG-1	GoodQuality
GGTGAAGCAGCTGTGC-1	GoodQuality
GGTGAAGCATGCCTTC-1	GoodQuality
GGTGAAGGTCCGACGT-1	LowQuality
GGTGAAGGTGCTCTTC-1	GoodQuality
GGTGAAGTCGCAAACT-1	GoodQuality
GGTGAAGTCGGTTAAC-1	GoodQuality
GGTGAAGTCTCTGCTG-1	LowQuality
GGTGCGTAGACTTTCG-1	GoodQuality
GGTGCGTAGCCACGTC-1	LowQuality
GGTGCGTCAAGAAGAG-1	GoodQuality
GGTGCGTCAATGGACG-1	GoodQuality
GGTGCGTCACTTCTGC-1	LowQuality
GGTGCGTTCCTTAATC-1	LowQuality
GGTGCGTTCGCAAACT-1	LowQuality
GGTGCGTTCGGAAATA-1	GoodQuality
GGTGTTAAGAGACGAA-1	GoodQuality
GGTGTTAAGCAACGGT-1	GoodQuality
GGTGTTAAGGATGGTC-1	GoodQuality
GGTGTTAAGGGCTTCC-1	LowQuality
GGTGTTAAGTCGTTTG-1	GoodQuality
GGTGTTACACATCCAA-1	LowQuality
GGTGTTACACGGACAA-1	LowQuality
GGTGTTACAGCTGTAT-1	GoodQuality
GGTGTTACAGGACGTA-1	GoodQuality
GGTGTTACATGACGGA-1	GoodQuality
GGTGTTACATTGCGGC-1	GoodQuality
GGTGTTAGTATTAGCC-1	GoodQuality
GGTGTTAGTGCATCTA-1	LowQuality
GGTGTTAGTGGCTCCA-1	LowQuality
GGTGTTAGTGGTACAG-1	LowQuality
GGTGTTATCCTCAATT-1	GoodQuality
GGTGTTATCTCAACTT-1	GoodQuality
GGTGTTATCTGCAAGT-1	GoodQuality
GTAACGTAGATACACA-1	LowQuality
GTAACGTAGGACCACA-1	LowQuality
GTAACGTCACTGTTAG-1	GoodQuality
GTAACGTCAGCCTTGG-1	GoodQuality
GTAACGTGTTGCGTTA-1	GoodQuality
GTAACGTTCAACACCA-1	LowQuality
GTAACGTTCAACACTG-1	GoodQuality
GTAACGTTCGCTAGCG-1	GoodQuality
GTAACGTTCTGTTGAG-1	LowQuality
GTAACTGAGCACCGCT-1	LowQuality
GTAACTGAGTACGATA-1	GoodQuality
GTAACTGCACGAGAGT-1	GoodQuality
GTAACTGCATCACAAC-1	GoodQuality
GTAACTGGTATGAATG-1	GoodQuality
GTAACTGGTCCAGTAT-1	LowQuality
GTAACTGGTCTCCACT-1	GoodQuality
GTAACTGGTTCAGTAC-1	GoodQuality
GTAACTGTCTAGAGTC-1	GoodQuality
GTAACTGTCTTCGGTC-1	GoodQuality
GTACGTACAGTAAGAT-1	GoodQuality
GTACGTACAGTCAGCC-1	GoodQuality
GTACGTACATACTACG-1	GoodQuality
GTACGTACATCCTAGA-1	GoodQuality
GTACGTAGTCCTCCAT-1	LowQuality
GTACGTAGTCTAAAGA-1	GoodQuality
GTACGTATCAATAAGG-1	GoodQuality
GTACTCCAGCAATCTC-1	LowQuality
GTACTCCAGTGTGGCA-1	LowQuality
GTACTCCAGTTACCCA-1	GoodQuality
GTACTCCCACACGCTG-1	GoodQuality
GTACTCCCACCAACCG-1	GoodQuality
GTACTCCCATCGGTTA-1	LowQuality
GTACTCCGTACCCAAT-1	GoodQuality
GTACTCCGTACCTACA-1	GoodQuality
GTACTCCGTCACTGGC-1	LowQuality
GTACTCCGTCGAAAGC-1	GoodQuality
GTACTCCGTGTGTGCC-1	GoodQuality
GTACTCCTCAGATAAG-1	LowQuality
GTACTCCTCATTTGGG-1	GoodQuality
GTACTCCTCCGCAGTG-1	GoodQuality
GTACTTTAGACGCTTT-1	GoodQuality
GTACTTTAGCGATAGC-1	GoodQuality
GTACTTTCAAGCCATT-1	LowQuality
GTACTTTCAAGGACAC-1	GoodQuality
GTACTTTCACGCATCG-1	LowQuality
GTACTTTCAGATCTGT-1	LowQuality
GTACTTTCAGCGTAAG-1	GoodQuality
GTACTTTGTACTTCTT-1	LowQuality
GTACTTTGTTGAGTTC-1	GoodQuality
GTACTTTGTTGTCTTT-1	GoodQuality
GTACTTTTCCTACAGA-1	GoodQuality
GTACTTTTCGACAGCC-1	GoodQuality
GTACTTTTCGGTCCGA-1	LowQuality
GTACTTTTCTGAGGGA-1	LowQuality
GTAGGCCAGCGTGAAC-1	GoodQuality
GTAGGCCCAAATTGCC-1	GoodQuality
GTAGGCCTCACCATAG-1	LowQuality
GTAGGCCTCAGCTTAG-1	GoodQuality
GTAGTCACACATTTCT-1	GoodQuality
GTAGTCAGTAACGTTC-1	GoodQuality
GTAGTCAGTGGGTATG-1	LowQuality
GTAGTCATCAGTCAGT-1	GoodQuality
GTAGTCATCCGGCACA-1	GoodQuality
GTAGTCATCCGTAGTA-1	GoodQuality
GTAGTCATCGCGATCG-1	GoodQuality
GTATCTTCACCCAGTG-1	GoodQuality
GTATCTTCACTAAGTC-1	LowQuality
GTATCTTGTTACGGAG-1	GoodQuality
GTATCTTGTTCAACCA-1	GoodQuality
GTATCTTTCATCACCC-1	GoodQuality
GTATCTTTCCGGGTGT-1	GoodQuality
GTATTCTAGCCCAATT-1	GoodQuality
GTATTCTAGCGTTTAC-1	LowQuality
GTATTCTAGGCACATG-1	LowQuality
GTATTCTAGGCCATAG-1	LowQuality
GTATTCTAGTAGCGGT-1	GoodQuality
GTATTCTAGTCGTACT-1	GoodQuality
GTATTCTCAGGGCATA-1	GoodQuality
GTATTCTCAGTAAGCG-1	GoodQuality
GTATTCTGTCTGGAGA-1	GoodQuality
GTATTCTGTGAGCGAT-1	LowQuality
GTATTCTTCATTGCCC-1	GoodQuality
GTATTCTTCCTTTCTC-1	GoodQuality
GTCAAGTCAATAACGA-1	GoodQuality
GTCAAGTCATGGAATA-1	GoodQuality
GTCAAGTGTCCTGCTT-1	GoodQuality
GTCAAGTGTCGCATAT-1	GoodQuality
GTCAAGTGTGATAAAC-1	GoodQuality
GTCAAGTGTTAGAACA-1	GoodQuality
GTCAAGTGTTCACGGC-1	GoodQuality
GTCAAGTTCAAACCAC-1	GoodQuality
GTCAAGTTCACTTACT-1	GoodQuality
GTCAAGTTCCTCAATT-1	LowQuality
GTCAAGTTCCTCATTA-1	GoodQuality
GTCAAGTTCGATGAGG-1	LowQuality
GTCACAAAGAATTGTG-1	LowQuality
GTCACAAAGCGTGTCC-1	GoodQuality
GTCACAAAGCTTTGGT-1	LowQuality
GTCACAACAAATACAG-1	GoodQuality
GTCACAACAAGGACAC-1	GoodQuality
GTCACAACACATGACT-1	LowQuality
GTCACAACAGACGCTC-1	LowQuality
GTCACAACAGGGATTG-1	GoodQuality
GTCACAACATCAGTAC-1	GoodQuality
GTCACAAGTGCCTGCA-1	GoodQuality
GTCACAATCACATGCA-1	GoodQuality
GTCACAATCGGAGCAA-1	GoodQuality
GTCACAATCTACCAGA-1	LowQuality
GTCACAATCTCAAGTG-1	GoodQuality
GTCACGGAGCTTTGGT-1	LowQuality
GTCACGGAGTAGGTGC-1	GoodQuality
GTCACGGCAAACGCGA-1	GoodQuality
GTCACGGCAATAGAGT-1	GoodQuality
GTCACGGCACAGACTT-1	GoodQuality
GTCACGGCACGGCGTT-1	GoodQuality
GTCACGGGTGGCTCCA-1	GoodQuality
GTCACGGTCGAGGTAG-1	GoodQuality
GTCATTTAGAGTCTGG-1	GoodQuality
GTCATTTAGCACCGTC-1	GoodQuality
GTCATTTAGTGCGTGA-1	GoodQuality
GTCATTTCACCACGTG-1	GoodQuality
GTCATTTCAGCTCGCA-1	LowQuality
GTCATTTCAGGTTTCA-1	GoodQuality
GTCATTTGTTCATGGT-1	GoodQuality
GTCATTTTCACAGGCC-1	GoodQuality
GTCATTTTCCTCTAGC-1	LowQuality
GTCATTTTCTCGCATC-1	GoodQuality
GTCCTCAAGCACACAG-1	GoodQuality
GTCCTCAAGTGACATA-1	GoodQuality
GTCCTCACAAGAGGCT-1	GoodQuality
GTCCTCACACCGAAAG-1	GoodQuality
GTCCTCAGTAGTAGTA-1	GoodQuality
GTCCTCAGTGAGGGTT-1	LowQuality
GTCCTCATCACTATTC-1	GoodQuality
GTCCTCATCAGCAACT-1	LowQuality
GTCCTCATCCATGAGT-1	GoodQuality
GTCCTCATCGCGTAGC-1	GoodQuality
GTCGGGTAGGGTCTCC-1	GoodQuality
GTCGGGTAGTGGTCCC-1	GoodQuality
GTCGGGTCACGACTCG-1	GoodQuality
GTCGGGTCAGTGACAG-1	GoodQuality
GTCGGGTCATGGTTGT-1	GoodQuality
GTCGGGTGTAGCGCTC-1	LowQuality
GTCGGGTGTGATAAGT-1	GoodQuality
GTCGGGTGTTGAGGTG-1	LowQuality
GTCGGGTTCACATAGC-1	GoodQuality
GTCGGGTTCTGAGGGA-1	GoodQuality
GTCGTAAAGAGCCTAG-1	GoodQuality
GTCGTAAAGCGAGAAA-1	LowQuality
GTCGTAAAGCGATGAC-1	GoodQuality
GTCGTAAAGGCACATG-1	GoodQuality
GTCGTAAAGTTAGGTA-1	GoodQuality
GTCGTAACACCACGTG-1	GoodQuality
GTCGTAACAGACGCAA-1	LowQuality
GTCGTAACAGCTGTGC-1	GoodQuality
GTCGTAAGTAGGAGTC-1	GoodQuality
GTCGTAAGTGCCTGCA-1	LowQuality
GTCGTAAGTGGTCTCG-1	GoodQuality
GTCGTAATCCAACCAA-1	LowQuality
GTCGTAATCCTTGGTC-1	LowQuality
GTCTCGTAGACTTGAA-1	GoodQuality
GTCTCGTAGCGTCTAT-1	GoodQuality
GTCTCGTAGTATGACA-1	LowQuality
GTCTCGTCAATGGAGC-1	GoodQuality
GTCTCGTCAGATCTGT-1	GoodQuality
GTCTCGTCAGCTCGAC-1	GoodQuality
GTCTCGTCATACGCCG-1	GoodQuality
GTCTCGTGTCACAAGG-1	GoodQuality
GTCTCGTGTCGCTTCT-1	GoodQuality
GTCTCGTGTCTGCAAT-1	GoodQuality
GTCTCGTGTTCTGAAC-1	LowQuality
GTCTTCGAGAAGATTC-1	GoodQuality
GTCTTCGAGCAACGGT-1	GoodQuality
GTCTTCGAGTAGATGT-1	LowQuality
GTCTTCGAGTGTCCCG-1	LowQuality
GTCTTCGGTCGGCACT-1	GoodQuality
GTCTTCGGTTAGGGTG-1	GoodQuality
GTCTTCGTCACCCGAG-1	GoodQuality
GTCTTCGTCCAGTATG-1	GoodQuality
GTCTTCGTCTCCTATA-1	GoodQuality
GTGAAGGAGCAAATCA-1	LowQuality
GTGAAGGAGTTGAGTA-1	GoodQuality
GTGAAGGCAATGGTCT-1	GoodQuality
GTGAAGGCACGACTCG-1	GoodQuality
GTGAAGGGTGCCTGGT-1	GoodQuality
GTGAAGGGTTTGCATG-1	GoodQuality
GTGAAGGTCAATACCG-1	GoodQuality
GTGAAGGTCAGCTCGG-1	GoodQuality
GTGAAGGTCCAGTAGT-1	GoodQuality
GTGAAGGTCTACCAGA-1	GoodQuality
GTGCAGCAGAATGTTG-1	GoodQuality
GTGCAGCAGACAAAGG-1	LowQuality
GTGCAGCAGCCGTCGT-1	LowQuality
GTGCAGCAGCGTAATA-1	LowQuality
GTGCAGCCAGCAGTTT-1	LowQuality
GTGCAGCGTCGGCACT-1	GoodQuality
GTGCAGCGTGAAATCA-1	LowQuality
GTGCAGCGTGCAACTT-1	GoodQuality
GTGCAGCGTGGCTCCA-1	GoodQuality
GTGCAGCGTTCGTCTC-1	GoodQuality
GTGCAGCGTTGATTGC-1	GoodQuality
GTGCAGCGTTGCCTCT-1	LowQuality
GTGCAGCTCAACCAAC-1	GoodQuality
GTGCAGCTCGGATGTT-1	GoodQuality
GTGCATAAGGGATGGG-1	LowQuality
GTGCATAAGGTGACCA-1	LowQuality
GTGCATACACAACTGT-1	GoodQuality
GTGCATACACTGCCAG-1	GoodQuality
GTGCATAGTAATTGGA-1	GoodQuality
GTGCATAGTCGTCTTC-1	LowQuality
GTGCATAGTGTGTGCC-1	GoodQuality
GTGCATATCCAAGCCG-1	GoodQuality
GTGCATATCCATGCTC-1	GoodQuality
GTGCGGTAGAGTGACC-1	GoodQuality
GTGCGGTCACAGCGTC-1	GoodQuality
GTGCGGTCACTTAAGC-1	LowQuality
GTGCGGTCAGTTCATG-1	GoodQuality
GTGCGGTCATGCCACG-1	GoodQuality
GTGCGGTGTTGGTTTG-1	GoodQuality
GTGCGGTTCAACGCTA-1	GoodQuality
GTGCGGTTCGATAGAA-1	LowQuality
GTGCGGTTCTCGAGTA-1	GoodQuality
GTGCTTCAGACTAAGT-1	LowQuality
GTGCTTCAGCCAACAG-1	LowQuality
GTGCTTCCATCGTCGG-1	LowQuality
GTGCTTCCATGCAATC-1	GoodQuality
GTGCTTCTCAGAGCTT-1	GoodQuality
GTGGGTCAGAGACTAT-1	GoodQuality
GTGGGTCAGAGCTATA-1	GoodQuality
GTGGGTCAGCTCCCAG-1	GoodQuality
GTGGGTCAGGTGTTAA-1	GoodQuality
GTGGGTCCAATAAGCA-1	GoodQuality
GTGGGTCCATAGTAAG-1	GoodQuality
GTGGGTCTCCTTGCCA-1	GoodQuality
GTGGGTCTCGGCGCAT-1	GoodQuality
GTGTGCGAGAGTGACC-1	GoodQuality
GTGTGCGAGCCAACAG-1	GoodQuality
GTGTGCGAGCTCTCGG-1	GoodQuality
GTGTGCGAGGATGTAT-1	LowQuality
GTGTGCGAGGTGCAAC-1	GoodQuality
GTGTGCGGTAGCCTAT-1	LowQuality
GTGTGCGGTCCAGTTA-1	GoodQuality
GTGTGCGGTTCGCTAA-1	GoodQuality
GTGTGCGGTTCGGGCT-1	GoodQuality
GTGTGCGTCCGCAAGC-1	GoodQuality
GTGTGCGTCCGGGTGT-1	GoodQuality
GTGTGCGTCTCCGGTT-1	GoodQuality
GTGTTAGAGTGAAGTT-1	LowQuality
GTGTTAGCACGTAAGG-1	LowQuality
GTGTTAGCACTGAAGG-1	GoodQuality
GTGTTAGCATCGACGC-1	GoodQuality
GTGTTAGGTACTTCTT-1	GoodQuality
GTGTTAGGTGAGTGAC-1	GoodQuality
GTGTTAGGTTATCCGA-1	GoodQuality
GTTAAGCAGATACACA-1	GoodQuality
GTTAAGCAGCGCTTAT-1	LowQuality
GTTAAGCCAAGCTGTT-1	LowQuality
GTTAAGCCAAGGCTCC-1	GoodQuality
GTTAAGCCACAGGAGT-1	GoodQuality
GTTAAGCGTATTAGCC-1	GoodQuality
GTTAAGCGTGCAGTAG-1	LowQuality
GTTAAGCTCAGCTTAG-1	GoodQuality
GTTACAGAGCCACGCT-1	GoodQuality
GTTACAGAGCCACTAT-1	GoodQuality
GTTACAGAGCTGCAAG-1	GoodQuality
GTTACAGAGTAGTGCG-1	LowQuality
GTTACAGCAATCTGCA-1	GoodQuality
GTTACAGCACCGATAT-1	GoodQuality
GTTACAGCAGCGATCC-1	GoodQuality
GTTACAGCAGGGAGAG-1	LowQuality
GTTACAGGTTCCCGAG-1	LowQuality
GTTACAGGTTGTCGCG-1	LowQuality
GTTACAGTCCATGAAC-1	GoodQuality
GTTCATTAGACTTTCG-1	GoodQuality
GTTCATTAGGAGTCTG-1	GoodQuality
GTTCATTCATACGCCG-1	GoodQuality
GTTCATTCATTCTCAT-1	LowQuality
GTTCATTGTCATCGGC-1	GoodQuality
GTTCATTTCTCCTATA-1	GoodQuality
GTTCATTTCTTTACGT-1	GoodQuality
GTTCGGGAGTAACCCT-1	GoodQuality
GTTCGGGCAAATCCGT-1	GoodQuality
GTTCGGGGTCGCTTTC-1	GoodQuality
GTTCGGGGTGATAAGT-1	GoodQuality
GTTCGGGTCCAAGCCG-1	LowQuality
GTTCGGGTCCGAGCCA-1	GoodQuality
GTTCGGGTCTGTCCGT-1	LowQuality
GTTCTCGAGAGTCTGG-1	LowQuality
GTTCTCGAGATGTTAG-1	GoodQuality
GTTCTCGAGTCAAGGC-1	LowQuality
GTTCTCGGTACTCAAC-1	GoodQuality
GTTCTCGGTTTGCATG-1	GoodQuality
GTTCTCGTCATTCACT-1	GoodQuality
GTTCTCGTCGCGATCG-1	LowQuality
GTTTCTACACATGTGT-1	GoodQuality
GTTTCTACACCTTGTC-1	GoodQuality
GTTTCTACATGGGAAC-1	GoodQuality
GTTTCTACATTTCACT-1	GoodQuality
GTTTCTAGTACCATCA-1	LowQuality
GTTTCTATCCTTGACC-1	LowQuality
GTTTCTATCGTGGTCG-1	LowQuality
GTTTCTATCTGCTGTC-1	LowQuality
TAAACCGAGATCCGAG-1	LowQuality
TAAACCGAGGTGGGTT-1	LowQuality
TAAACCGAGTCTCCTC-1	GoodQuality
TAAACCGCAGAGTGTG-1	LowQuality
TAAACCGGTCAAAGAT-1	LowQuality
TAAACCGGTCACAAGG-1	GoodQuality
TAAACCGGTCATGCCG-1	GoodQuality
TAAACCGTCAACGAAA-1	GoodQuality
TAAACCGTCAGGCGAA-1	GoodQuality
TAAACCGTCCCAAGAT-1	LowQuality
TAAGAGAAGACAAAGG-1	LowQuality
TAAGAGAAGGACATTA-1	LowQuality
TAAGAGAAGGCGCTCT-1	LowQuality
TAAGAGACAAGGCTCC-1	GoodQuality
TAAGAGACAAGTTCTG-1	GoodQuality
TAAGAGAGTGAAATCA-1	LowQuality
TAAGAGATCAAGATCC-1	GoodQuality
TAAGAGATCCTATTCA-1	GoodQuality
TAAGCGTAGCAAATCA-1	GoodQuality
TAAGCGTCAAACCCAT-1	GoodQuality
TAAGCGTCAGTCACTA-1	LowQuality
TAAGCGTCATACGCTA-1	GoodQuality
TAAGCGTGTAGGGACT-1	GoodQuality
TAAGCGTGTGCAGACA-1	GoodQuality
TAAGCGTGTTATGCGT-1	GoodQuality
TAAGCGTGTTCCAACA-1	GoodQuality
TAAGCGTTCCATGAAC-1	GoodQuality
TAAGCGTTCGTTTGCC-1	GoodQuality
TAAGTGCAGCTTCGCG-1	GoodQuality
TAAGTGCAGGGAGTAA-1	LowQuality
TAAGTGCAGTCTCAAC-1	GoodQuality
TAAGTGCCAACGCACC-1	GoodQuality
TAAGTGCCAAGCGCTC-1	LowQuality
TAAGTGCCACAACGTT-1	GoodQuality
TAAGTGCCACAACTGT-1	LowQuality
TAAGTGCCATGCAACT-1	GoodQuality
TAAGTGCCATTGGTAC-1	LowQuality
TAAGTGCGTCTAGTGT-1	GoodQuality
TAAGTGCGTGGTGTAG-1	GoodQuality
TAAGTGCGTTCGGCAC-1	LowQuality
TAAGTGCGTTGGTTTG-1	GoodQuality
TACACGAAGATATACG-1	GoodQuality
TACACGAAGTCGAGTG-1	LowQuality
TACACGACACTCTGTC-1	LowQuality
TACACGACATGTTGAC-1	GoodQuality
TACACGAGTAATCGTC-1	GoodQuality
TACACGAGTCAACATC-1	GoodQuality
TACACGAGTCTGATTG-1	GoodQuality
TACACGAGTCTGGTCG-1	LowQuality
TACACGATCTCGTATT-1	GoodQuality
TACACGATCTTGAGGT-1	GoodQuality
TACAGTGAGCTTTGGT-1	LowQuality
TACAGTGAGTCCATAC-1	LowQuality
TACAGTGCAAGAGGCT-1	GoodQuality
TACAGTGCAAGTCTAC-1	GoodQuality
TACAGTGCAGGACCCT-1	LowQuality
TACAGTGGTCGTTGTA-1	GoodQuality
TACAGTGGTCTTGATG-1	GoodQuality
TACAGTGGTGCGCTTG-1	GoodQuality
TACAGTGTCAGCAACT-1	LowQuality
TACAGTGTCTTACCGC-1	GoodQuality
TACAGTGTCTTGACGA-1	GoodQuality
TACCTATAGACGCACA-1	LowQuality
TACCTATAGACTTGAA-1	GoodQuality
TACCTATAGAGAACAG-1	GoodQuality
TACCTATCAAGTAGTA-1	GoodQuality
TACCTATCACCAGGTC-1	LowQuality
TACCTATCACCATCCT-1	LowQuality
TACCTATCATCTACGA-1	GoodQuality
TACCTATGTTAAGACA-1	LowQuality
TACCTATTCATCTGTT-1	LowQuality
TACCTATTCGGAGGTA-1	LowQuality
TACCTATTCTACGAGT-1	GoodQuality
TACCTATTCTCCCTGA-1	LowQuality
TACCTTAAGGTGATAT-1	GoodQuality
TACCTTACAGCCTTTC-1	GoodQuality
TACCTTAGTAAATGTG-1	GoodQuality
TACCTTAGTTGATTCG-1	LowQuality
TACCTTATCCAACCAA-1	GoodQuality
TACCTTATCCACGCAG-1	GoodQuality
TACCTTATCCGTCATC-1	GoodQuality
TACCTTATCCTGCAGG-1	LowQuality
TACCTTATCTCGTTTA-1	LowQuality
TACGGATAGATGTGTA-1	GoodQuality
TACGGATAGCTGATAA-1	GoodQuality
TACGGATAGGATGGAA-1	LowQuality
TACGGATAGGTCATCT-1	GoodQuality
TACGGATAGTCTCCTC-1	GoodQuality
TACGGATAGTGTACTC-1	LowQuality
TACGGATCAAACAACA-1	GoodQuality
TACGGATCAATGCCAT-1	GoodQuality
TACGGATCACACCGAC-1	LowQuality
TACGGATCACGGTAGA-1	LowQuality
TACGGATCATCACCCT-1	GoodQuality
TACGGATCATCCTAGA-1	GoodQuality
TACGGATCATCGACGC-1	GoodQuality
TACGGATCATGCAACT-1	GoodQuality
TACGGATTCAGTCCCT-1	GoodQuality
TACGGATTCATGGTCA-1	GoodQuality
TACGGATTCCCTCTTT-1	GoodQuality
TACGGATTCCGTCATC-1	GoodQuality
TACGGATTCGACAGCC-1	GoodQuality
TACGGATTCTTCATGT-1	GoodQuality
TACGGGCAGTTATCGC-1	GoodQuality
TACGGGCGTAAATGAC-1	GoodQuality
TACGGGCGTGTGGCTC-1	GoodQuality
TACGGGCGTTATGCGT-1	LowQuality
TACGGGCTCCAGAAGG-1	GoodQuality
TACGGTAAGGGTGTTG-1	LowQuality
TACGGTAAGTGAAGTT-1	LowQuality
TACGGTACAGCCTGTG-1	LowQuality
TACGGTACAGTAGAGC-1	GoodQuality
TACGGTAGTAGCGCTC-1	GoodQuality
TACGGTATCGACGGAA-1	LowQuality
TACTCATAGCGCTTAT-1	GoodQuality
TACTCATAGTCATGCT-1	GoodQuality
TACTCATCAAGTTCTG-1	LowQuality
TACTCATCACCGCTAG-1	GoodQuality
TACTCATCATTGGTAC-1	LowQuality
TACTCATGTCGCATCG-1	GoodQuality
TACTCATGTTATGTGC-1	GoodQuality
TACTCATGTTCCCTTG-1	LowQuality
TACTCATTCATGTAGC-1	GoodQuality
TACTCATTCATTATCC-1	GoodQuality
TACTCATTCCAGTAGT-1	GoodQuality
TACTCGCCAGGAATGC-1	GoodQuality
TACTCGCGTAAATGAC-1	LowQuality
TACTCGCGTCGAGTTT-1	LowQuality
TACTCGCTCCACTGGG-1	GoodQuality
TACTCGCTCTCGAGTA-1	LowQuality
TACTCGCTCTTGTACT-1	LowQuality
TACTTACAGCAGGTCA-1	LowQuality
TACTTACAGTACACCT-1	LowQuality
TACTTACAGTGAAGTT-1	GoodQuality
TACTTACCACAGGAGT-1	GoodQuality
TACTTACCACCTTGTC-1	LowQuality
TACTTACCAGGGCATA-1	GoodQuality
TACTTACGTGTGAAAT-1	GoodQuality
TACTTACGTTGAGTTC-1	GoodQuality
TACTTGTAGGTCGGAT-1	GoodQuality
TACTTGTAGTTGAGAT-1	LowQuality
TACTTGTCATCTGGTA-1	GoodQuality
TACTTGTGTCAGAATA-1	GoodQuality
TACTTGTGTCCGACGT-1	GoodQuality
TACTTGTTCCACGTGG-1	LowQuality
TACTTGTTCTTGTCAT-1	LowQuality
TAGACCAAGAAGGGTA-1	GoodQuality
TAGACCAGTGGCTCCA-1	GoodQuality
TAGACCAGTTCACCTC-1	GoodQuality
TAGACCAGTTCTGGTA-1	GoodQuality
TAGACCAGTTGGTTTG-1	GoodQuality
TAGACCATCAGTTTGG-1	GoodQuality
TAGACCATCGGTTAAC-1	GoodQuality
TAGAGCTAGAGGTAGA-1	GoodQuality
TAGAGCTAGCGACGTA-1	GoodQuality
TAGAGCTAGCGCTCCA-1	GoodQuality
TAGAGCTAGGATATAC-1	GoodQuality
TAGAGCTCAGTTTACG-1	GoodQuality
TAGAGCTGTCTAGAGG-1	GoodQuality
TAGAGCTTCCGCATAA-1	GoodQuality
TAGAGCTTCTGGTATG-1	GoodQuality
TAGCCGGCATCGGAAG-1	GoodQuality
TAGCCGGCATTTCAGG-1	LowQuality
TAGCCGGTCGTTGACA-1	GoodQuality
TAGGCATAGTACTTGC-1	GoodQuality
TAGGCATAGTCCTCCT-1	LowQuality
TAGGCATAGTCGATAA-1	GoodQuality
TAGGCATCAACAACCT-1	LowQuality
TAGGCATCAAGGTTTC-1	GoodQuality
TAGGCATCAATCTACG-1	LowQuality
TAGGCATCACGGATAG-1	LowQuality
TAGGCATGTCAGAGGT-1	GoodQuality
TAGGCATGTCAGATAA-1	GoodQuality
TAGGCATGTTAAGATG-1	GoodQuality
TAGGCATTCATCTGCC-1	GoodQuality
TAGGCATTCCAATGGT-1	LowQuality
TAGTGGTAGGACTGGT-1	GoodQuality
TAGTGGTAGTTGAGTA-1	GoodQuality
TAGTGGTCAAGAGTCG-1	GoodQuality
TAGTGGTCACCACCAG-1	GoodQuality
TAGTGGTCACCTTGTC-1	GoodQuality
TAGTGGTCATCGACGC-1	LowQuality
TAGTGGTGTACCGTTA-1	GoodQuality
TAGTGGTGTCGTTGTA-1	GoodQuality
TAGTGGTGTGCTTCTC-1	GoodQuality
TAGTGGTGTGTAATGA-1	LowQuality
TAGTGGTTCACGAAGG-1	GoodQuality
TAGTTGGAGAATTGTG-1	GoodQuality
TAGTTGGAGGCAGGTT-1	LowQuality
TAGTTGGCAAGCTGGA-1	GoodQuality
TAGTTGGCACAGATTC-1	GoodQuality
TAGTTGGCACTGCCAG-1	LowQuality
TAGTTGGGTCCGTCAG-1	GoodQuality
TAGTTGGGTTGGTAAA-1	GoodQuality
TAGTTGGGTTTGGGCC-1	GoodQuality
TAGTTGGTCAACCATG-1	GoodQuality
TAGTTGGTCAACGCTA-1	LowQuality
TAGTTGGTCAGTTAGC-1	LowQuality
TATCAGGAGAGTGAGA-1	LowQuality
TATCAGGAGATGGCGT-1	GoodQuality
TATCAGGAGTAGGCCA-1	LowQuality
TATCAGGAGTCCCACG-1	GoodQuality
TATCAGGCAAAGGCGT-1	GoodQuality
TATCAGGCATGGTCTA-1	LowQuality
TATCAGGCATTCTTAC-1	LowQuality
TATCAGGCATTGCGGC-1	LowQuality
TATCAGGGTAATCGTC-1	GoodQuality
TATCAGGGTACCAGTT-1	GoodQuality
TATCAGGGTAGGACAC-1	LowQuality
TATCAGGGTGCGAAAC-1	LowQuality
TATCAGGTCGGAAATA-1	GoodQuality
TATCAGGTCGGAGCAA-1	GoodQuality
TATCAGGTCTACTTAC-1	GoodQuality
TATCAGGTCTTCGAGA-1	GoodQuality
TATCAGGTCTTCGGTC-1	GoodQuality
TATCTCACATTCACTT-1	GoodQuality
TATCTCAGTAGCCTAT-1	GoodQuality
TATCTCAGTATTCGTG-1	GoodQuality
TATCTCAGTGGAAAGA-1	LowQuality
TATGCCCAGCAGACTG-1	GoodQuality
TATGCCCCAAACTGTC-1	GoodQuality
TATGCCCCAAGGTTTC-1	GoodQuality
TATGCCCCAGACACTT-1	GoodQuality
TATGCCCGTAAGTAGT-1	LowQuality
TATGCCCGTGAACCTT-1	LowQuality
TATGCCCGTTAAGGGC-1	GoodQuality
TATGCCCGTTCAGTAC-1	LowQuality
TATGCCCGTTCCTCCA-1	GoodQuality
TATGCCCTCGGACAAG-1	GoodQuality
TATGCCCTCGTAGATC-1	GoodQuality
TATTACCAGAAGGCCT-1	GoodQuality
TATTACCAGTACGTTC-1	GoodQuality
TATTACCAGTGTGAAT-1	LowQuality
TATTACCGTACCAGTT-1	GoodQuality
TATTACCGTAGCGCAA-1	GoodQuality
TATTACCGTCAAAGCG-1	LowQuality
TATTACCTCAAACAAG-1	LowQuality
TATTACCTCACCTTAT-1	GoodQuality
TATTACCTCAGGTAAA-1	GoodQuality
TATTACCTCCAGATCA-1	LowQuality
TATTACCTCCCTCTTT-1	LowQuality
TATTACCTCTAACTTC-1	LowQuality
TATTACCTCTCAAGTG-1	GoodQuality
TCAACGAAGGTGATAT-1	GoodQuality
TCAACGAAGTACGTTC-1	GoodQuality
TCAACGAAGTCTCAAC-1	LowQuality
TCAACGAAGTGGGCTA-1	GoodQuality
TCAACGACACGCGAAA-1	LowQuality
TCAACGAGTCGCGGTT-1	GoodQuality
TCAACGAGTTAAAGAC-1	LowQuality
TCAACGAGTTAGAACA-1	LowQuality
TCAATCTAGACATAAC-1	GoodQuality
TCAATCTTCATTATCC-1	GoodQuality
TCAATCTTCGAACGGA-1	GoodQuality
TCAATCTTCTAACTTC-1	LowQuality
TCAATCTTCTCTGTCG-1	GoodQuality
TCACAAGAGCGATATA-1	LowQuality
TCACAAGAGTGGGATC-1	GoodQuality
TCACAAGCAATAGAGT-1	GoodQuality
TCACAAGCACACCGAC-1	GoodQuality
TCACAAGCACCCAGTG-1	LowQuality
TCACAAGGTAAACACA-1	LowQuality
TCACAAGGTAGCGTCC-1	GoodQuality
TCACAAGGTGAGGGTT-1	GoodQuality
TCACAAGTCACTTCAT-1	GoodQuality
TCACAAGTCCCATTTA-1	LowQuality
TCACAAGTCCTTGGTC-1	LowQuality
TCACGAAAGAAGGACA-1	LowQuality
TCACGAAAGCGCTCCA-1	LowQuality
TCACGAACATCTACGA-1	GoodQuality
TCACGAAGTAATCACC-1	GoodQuality
TCACGAATCACCTTAT-1	GoodQuality
TCACGAATCGTAGGAG-1	LowQuality
TCACGAATCTGTACGA-1	GoodQuality
TCAGATGAGAAGGACA-1	GoodQuality
TCAGATGAGGATGTAT-1	GoodQuality
TCAGATGAGTAATCCC-1	GoodQuality
TCAGATGCAAACCTAC-1	GoodQuality
TCAGATGCAGCCTGTG-1	GoodQuality
TCAGATGCAGGGATTG-1	LowQuality
TCAGATGTCAGAGCTT-1	GoodQuality
TCAGATGTCAGCATGT-1	GoodQuality
TCAGATGTCATGCATG-1	GoodQuality
TCAGATGTCCGCATCT-1	GoodQuality
TCAGATGTCGCCTGTT-1	GoodQuality
TCAGATGTCGGGAGTA-1	GoodQuality
TCAGATGTCGTGGGAA-1	GoodQuality
TCAGATGTCTTGTCAT-1	GoodQuality
TCAGCAAAGACGCACA-1	GoodQuality
TCAGCAAAGCCAGTAG-1	GoodQuality
TCAGCAAGTAATAGCA-1	GoodQuality
TCAGCAAGTAGCCTAT-1	GoodQuality
TCAGCAATCAGCACAT-1	GoodQuality
TCAGCAATCCGAACGC-1	GoodQuality
TCAGCAATCTCTGCTG-1	GoodQuality
TCAGCTCAGCCGTCGT-1	GoodQuality
TCAGCTCAGGAATCGC-1	GoodQuality
TCAGCTCAGGCTAGAC-1	LowQuality
TCAGCTCAGGTGTGGT-1	LowQuality
TCAGCTCAGTGACTCT-1	LowQuality
TCAGCTCAGTGGTCCC-1	LowQuality
TCAGCTCAGTTCGCAT-1	GoodQuality
TCAGCTCCACACCGAC-1	GoodQuality
TCAGCTCGTACCGTAT-1	GoodQuality
TCAGCTCGTAGTACCT-1	LowQuality
TCAGCTCTCAGCATGT-1	GoodQuality
TCAGGATAGAAGAAGC-1	LowQuality
TCAGGATAGACCTAGG-1	GoodQuality
TCAGGATAGGGTCTCC-1	GoodQuality
TCAGGATAGTAACCCT-1	GoodQuality
TCAGGATCACCAGATT-1	GoodQuality
TCAGGATCAGCGTAAG-1	GoodQuality
TCAGGATCAGTTTACG-1	LowQuality
TCAGGATGTGCAGTAG-1	GoodQuality
TCAGGATGTTCAGCGC-1	GoodQuality
TCAGGATTCTTACCGC-1	GoodQuality
TCAGGTAAGAAGGTGA-1	LowQuality
TCAGGTAAGATTACCC-1	GoodQuality
TCAGGTACAAATTGCC-1	GoodQuality
TCAGGTACACACCGAC-1	GoodQuality
TCAGGTACAGCCTTGG-1	GoodQuality
TCAGGTAGTCAATGTC-1	GoodQuality
TCAGGTAGTTCCATGA-1	LowQuality
TCAGGTATCACTGGGC-1	GoodQuality
TCAGGTATCCGCGCAA-1	GoodQuality
TCAGGTATCTCGGACG-1	GoodQuality
TCATTACAGGAGTCTG-1	LowQuality
TCATTACAGTCCAGGA-1	GoodQuality
TCATTACCACACCGAC-1	GoodQuality
TCATTACCATAACCTG-1	GoodQuality
TCATTACCATTTGCCC-1	GoodQuality
TCATTACGTACAGTGG-1	LowQuality
TCATTACGTTACGGAG-1	GoodQuality
TCATTACGTTCAGACT-1	LowQuality
TCATTACTCAACGGCC-1	GoodQuality
TCATTACTCCCATTTA-1	GoodQuality
TCATTACTCCGTAGTA-1	GoodQuality
TCATTACTCGTCGTTC-1	GoodQuality
TCATTTGAGCTGCGAA-1	LowQuality
TCATTTGCAACTGCGC-1	GoodQuality
TCATTTGCAAGCGATG-1	LowQuality
TCATTTGCAAGTTGTC-1	LowQuality
TCATTTGCAGATCGGA-1	LowQuality
TCATTTGCATAGAAAC-1	GoodQuality
TCATTTGGTCCAAGTT-1	LowQuality
TCATTTGGTGATGTCT-1	GoodQuality
TCATTTGGTTATCGGT-1	GoodQuality
TCATTTGGTTCGGGCT-1	LowQuality
TCATTTGTCATTTGGG-1	GoodQuality
TCCACACAGACTTGAA-1	GoodQuality
TCCACACAGAGGGATA-1	GoodQuality
TCCACACAGCTTTGGT-1	LowQuality
TCCACACAGGATATAC-1	GoodQuality
TCCACACCACTACAGT-1	GoodQuality
TCCACACGTCTTTCAT-1	LowQuality
TCCACACGTGCACGAA-1	LowQuality
TCCACACGTGTGACGA-1	GoodQuality
TCCACACGTGTTGAGG-1	LowQuality
TCCACACTCTGTTGAG-1	GoodQuality
TCCCGATAGCTAGCCC-1	LowQuality
TCCCGATAGTGGGCTA-1	GoodQuality
TCCCGATCACTTCGAA-1	LowQuality
TCCCGATCATCCCATC-1	GoodQuality
TCCCGATGTAGTACCT-1	GoodQuality
TCCCGATGTCAGATAA-1	GoodQuality
TCCCGATTCACCCGAG-1	LowQuality
TCCCGATTCCACTCCA-1	GoodQuality
TCGAGGCAGAGGTTAT-1	GoodQuality
TCGAGGCAGTCATCCA-1	GoodQuality
TCGAGGCCAGCCTTGG-1	GoodQuality
TCGAGGCCAGCTTCGG-1	GoodQuality
TCGAGGCCAGGTGCCT-1	GoodQuality
TCGAGGCCATAGACTC-1	GoodQuality
TCGAGGCCATTAGGCT-1	GoodQuality
TCGAGGCGTAAGGATT-1	GoodQuality
TCGAGGCGTTCCCGAG-1	GoodQuality
TCGAGGCTCCATGAAC-1	LowQuality
TCGCGAGAGAACTGTA-1	GoodQuality
TCGCGAGAGACACGAC-1	GoodQuality
TCGCGAGAGTCGTTTG-1	GoodQuality
TCGCGAGCAGACTCGC-1	LowQuality
TCGCGAGCATGTTCCC-1	GoodQuality
TCGCGAGCATTGAGCT-1	GoodQuality
TCGCGAGGTCCTAGCG-1	LowQuality
TCGCGAGGTTCAGCGC-1	GoodQuality
TCGCGAGTCGAACGGA-1	GoodQuality
TCGCGAGTCTAACTTC-1	GoodQuality
TCGCGTTAGCCAACAG-1	LowQuality
TCGCGTTAGGCAATTA-1	GoodQuality
TCGCGTTAGTGACATA-1	GoodQuality
TCGCGTTCAAGAGGCT-1	GoodQuality
TCGCGTTCAGCTGTGC-1	GoodQuality
TCGCGTTCATAGAAAC-1	GoodQuality
TCGCGTTCATGCTAGT-1	GoodQuality
TCGCGTTGTAGGCTGA-1	GoodQuality
TCGCGTTGTTTCGCTC-1	LowQuality
TCGCGTTGTTTGCATG-1	GoodQuality
TCGCGTTTCATGTAGC-1	GoodQuality
TCGCGTTTCCACTGGG-1	GoodQuality
TCGCGTTTCCTTTCTC-1	GoodQuality
TCGGGACAGGAATGGA-1	GoodQuality
TCGGGACAGGCCCTCA-1	LowQuality
TCGGGACAGTCCTCCT-1	GoodQuality
TCGGGACCAAGACACG-1	GoodQuality
TCGGGACCAGGCTGAA-1	GoodQuality
TCGGGACGTCAAGCGA-1	GoodQuality
TCGGGACGTCTTCTCG-1	LowQuality
TCGGGACTCTAGCACA-1	GoodQuality
TCGGGACTCTCGCATC-1	GoodQuality
TCGGGACTCTGCTGTC-1	GoodQuality
TCGGGACTCTTGTATC-1	LowQuality
TCGGTAAAGTTACGGG-1	LowQuality
TCGGTAACAAACTGCT-1	GoodQuality
TCGGTAACACAACGTT-1	GoodQuality
TCGGTAACACAACTGT-1	GoodQuality
TCGGTAACACGGTTTA-1	GoodQuality
TCGGTAACAGTGACAG-1	LowQuality
TCGGTAACAGTTTACG-1	GoodQuality
TCGGTAACATGTCTCC-1	GoodQuality
TCGGTAAGTCTGGTCG-1	GoodQuality
TCGGTAAGTCTTGATG-1	GoodQuality
TCGGTAAGTTAGAACA-1	GoodQuality
TCGGTAATCCGTCATC-1	LowQuality
TCGGTAATCTAACTGG-1	LowQuality
TCGGTAATCTGAGTGT-1	GoodQuality
TCGTACCAGATAGCAT-1	GoodQuality
TCGTACCCACAGCGTC-1	GoodQuality
TCGTACCGTTTAAGCC-1	GoodQuality
TCGTACCGTTTACTCT-1	GoodQuality
TCGTACCTCTGGAGCC-1	GoodQuality
TCGTACCTCTTATCTG-1	LowQuality
TCGTAGAAGACTCGGA-1	GoodQuality
TCGTAGAAGCCACGTC-1	LowQuality
TCGTAGAAGTAGCCGA-1	LowQuality
TCGTAGACAAACAACA-1	LowQuality
TCGTAGACACAGGCCT-1	LowQuality
TCGTAGACATCCAACA-1	GoodQuality
TCGTAGAGTCGGCTCA-1	GoodQuality
TCGTAGATCGCTAGCG-1	GoodQuality
TCGTAGATCGTAGATC-1	GoodQuality
TCGTAGATCTCAAACG-1	LowQuality
TCTATTGAGTAGTGCG-1	LowQuality
TCTATTGCAATGCCAT-1	GoodQuality
TCTATTGCACCAGTTA-1	GoodQuality
TCTATTGTCAACGAAA-1	GoodQuality
TCTATTGTCAGGTAAA-1	LowQuality
TCTATTGTCGTAGATC-1	GoodQuality
TCTATTGTCGTGACAT-1	GoodQuality
TCTATTGTCTGTACGA-1	LowQuality
TCTATTGTCTTGACGA-1	GoodQuality
TCTCATAAGAAGGCCT-1	GoodQuality
TCTCATAAGTACCGGA-1	GoodQuality
TCTCATACAGCGATCC-1	LowQuality
TCTCATACAGGTGCCT-1	LowQuality
TCTCATATCAACGGCC-1	GoodQuality
TCTCATATCATTGCCC-1	LowQuality
TCTCATATCTGAGGGA-1	GoodQuality
TCTCTAAAGCGTGAAC-1	GoodQuality
TCTCTAACAATCTACG-1	GoodQuality
TCTCTAACAGTCGTGC-1	GoodQuality
TCTCTAATCTCTTATG-1	GoodQuality
TCTCTAATCTGAGTGT-1	LowQuality
TCTGAGACAATCTACG-1	LowQuality
TCTGAGAGTAACGACG-1	GoodQuality
TCTGAGAGTAGAGCTG-1	LowQuality
TCTGAGAGTTGATTCG-1	GoodQuality
TCTGAGAGTTTGTGTG-1	LowQuality
TCTGAGATCCGGGTGT-1	GoodQuality
TCTGAGATCGCCCTTA-1	LowQuality
TCTGAGATCTAAGCCA-1	GoodQuality
TCTGAGATCTCCAGGG-1	GoodQuality
TCTGGAAAGAGAGCTC-1	GoodQuality
TCTGGAAAGCACACAG-1	LowQuality
TCTGGAAAGCGGCTTC-1	GoodQuality
TCTGGAAAGCGTTTAC-1	GoodQuality
TCTGGAAAGTGGGTTG-1	LowQuality
TCTGGAAAGTTCGCAT-1	GoodQuality
TCTGGAACAAGGTTCT-1	LowQuality
TCTGGAACAAGTTGTC-1	GoodQuality
TCTGGAACACCATGTA-1	LowQuality
TCTGGAACATAAAGGT-1	GoodQuality
TCTGGAACATGTTGAC-1	GoodQuality
TCTGGAAGTAAGTTCC-1	GoodQuality
TCTGGAATCACCACCT-1	GoodQuality
TCTGGAATCCGTTGTC-1	GoodQuality
TCTGGAATCCTCAATT-1	GoodQuality
TCTGGAATCCTGTAGA-1	GoodQuality
TCTTCGGAGAGCCTAG-1	LowQuality
TCTTCGGAGATCCCAT-1	GoodQuality
TCTTCGGAGCCGATTT-1	GoodQuality
TCTTCGGAGTTACGGG-1	GoodQuality
TCTTCGGCAACCGCCA-1	GoodQuality
TCTTCGGCATACCATG-1	GoodQuality
TCTTCGGGTCAGAATA-1	LowQuality
TCTTCGGTCCGCATCT-1	GoodQuality
TCTTCGGTCGTTGCCT-1	LowQuality
TCTTCGGTCTTGTTTG-1	GoodQuality
TCTTTCCAGCACAGGT-1	LowQuality
TCTTTCCAGGCGTACA-1	GoodQuality
TCTTTCCAGTCCGGTC-1	LowQuality
TCTTTCCAGTTTCCTT-1	GoodQuality
TCTTTCCCAATCAGAA-1	LowQuality
TCTTTCCCAATTCCTT-1	LowQuality
TCTTTCCCAGTAACGG-1	LowQuality
TCTTTCCGTAAGTAGT-1	GoodQuality
TCTTTCCGTCGGCATC-1	GoodQuality
TCTTTCCGTGTGGTTT-1	LowQuality
TCTTTCCGTTGCGTTA-1	GoodQuality
TCTTTCCTCCAAGCCG-1	LowQuality
TCTTTCCTCTACTATC-1	GoodQuality
TCTTTCCTCTTGAGGT-1	GoodQuality
TGAAAGAAGCAATATG-1	LowQuality
TGAAAGAAGGACAGCT-1	GoodQuality
TGAAAGAAGTGGTAAT-1	GoodQuality
TGAAAGAGTAAGGGCT-1	LowQuality
TGAAAGAGTCTGCGGT-1	GoodQuality
TGAAAGATCAGGTTCA-1	GoodQuality
TGACAACAGCTCCCAG-1	GoodQuality
TGACAACAGCTCCTTC-1	GoodQuality
TGACAACAGTTCGATC-1	GoodQuality
TGACAACGTAAGGATT-1	GoodQuality
TGACAACGTATCTGCA-1	GoodQuality
TGACAACGTCAAACTC-1	LowQuality
TGACAACGTCACTGGC-1	LowQuality
TGACAACGTCATTAGC-1	LowQuality
TGACAACGTCCCGACA-1	GoodQuality
TGACAACGTCGAGTTT-1	LowQuality
TGACAACTCAGTGTTG-1	GoodQuality
TGACGGCAGGCAGGTT-1	LowQuality
TGACGGCAGGGTTCCC-1	GoodQuality
TGACGGCCAATGGAAT-1	LowQuality
TGACGGCCACTCAGGC-1	LowQuality
TGACGGCCATCATCCC-1	GoodQuality
TGACGGCGTTATGTGC-1	GoodQuality
TGACGGCTCCCAACGG-1	LowQuality
TGACGGCTCGCCTGTT-1	GoodQuality
TGACGGCTCTGCTTGC-1	GoodQuality
TGACTAGCATCTGGTA-1	GoodQuality
TGACTAGGTAAATGTG-1	GoodQuality
TGACTAGGTAGCTGCC-1	GoodQuality
TGACTAGGTCGCGGTT-1	GoodQuality
TGACTAGTCGCCGTGA-1	GoodQuality
TGACTAGTCTCGTTTA-1	GoodQuality
TGACTTTAGGAATGGA-1	GoodQuality
TGACTTTAGTCCGGTC-1	GoodQuality
TGACTTTGTAAGTAGT-1	GoodQuality
TGACTTTTCTAGCACA-1	GoodQuality
TGAGAGGAGCATCATC-1	GoodQuality
TGAGAGGAGGGATGGG-1	GoodQuality
TGAGAGGAGTGTCTCA-1	GoodQuality
TGAGAGGCACCGATAT-1	GoodQuality
TGAGAGGCATAGGATA-1	GoodQuality
TGAGAGGCATGCCTTC-1	GoodQuality
TGAGAGGGTCAACATC-1	GoodQuality
TGAGAGGGTCACTTCC-1	LowQuality
TGAGAGGGTGGAAAGA-1	LowQuality
TGAGAGGTCACGGTTA-1	GoodQuality
TGAGAGGTCGGCTTGG-1	LowQuality
TGAGAGGTCGTACCGG-1	GoodQuality
TGAGCATAGATGCCTT-1	GoodQuality
TGAGCATAGGACCACA-1	LowQuality
TGAGCATGTACAAGTA-1	GoodQuality
TGAGCATGTACTCGCG-1	GoodQuality
TGAGCATGTTGATTCG-1	GoodQuality
TGAGCATTCACAGGCC-1	GoodQuality
TGAGCATTCCTGTACC-1	GoodQuality
TGAGCCGAGACACTAA-1	LowQuality
TGAGCCGCAAGTCTGT-1	GoodQuality
TGAGCCGCACGCATCG-1	GoodQuality
TGAGCCGCATTGTGCA-1	GoodQuality
TGAGCCGGTATCAGTC-1	LowQuality
TGAGCCGGTCACACGC-1	GoodQuality
TGAGCCGTCACAATGC-1	LowQuality
TGAGCCGTCCGTACAA-1	GoodQuality
TGAGCCGTCGCACTCT-1	LowQuality
TGAGCCGTCGTCCGTT-1	LowQuality
TGAGCCGTCTTTCCTC-1	LowQuality
TGAGGGAAGGTAAACT-1	LowQuality
TGAGGGAAGTGAACAT-1	GoodQuality
TGAGGGAAGTGAAGAG-1	GoodQuality
TGAGGGACAAATACAG-1	LowQuality
TGAGGGACAACACCTA-1	GoodQuality
TGAGGGAGTATATGGA-1	GoodQuality
TGAGGGAGTCAGAAGC-1	LowQuality
TGAGGGAGTGAGGGTT-1	LowQuality
TGAGGGATCTGGGCCA-1	LowQuality
TGATTTCAGCGACGTA-1	GoodQuality
TGATTTCAGGCAAAGA-1	GoodQuality
TGATTTCCACGACTCG-1	GoodQuality
TGATTTCGTCTAAAGA-1	GoodQuality
TGATTTCGTGAACCTT-1	GoodQuality
TGATTTCGTGCTCTTC-1	LowQuality
TGATTTCGTGTGGTTT-1	GoodQuality
TGCACCTAGACCCACC-1	GoodQuality
TGCACCTAGCCTCGTG-1	GoodQuality
TGCACCTAGTTTAGGA-1	LowQuality
TGCACCTCAACTGGCC-1	GoodQuality
TGCACCTCACAGACTT-1	GoodQuality
TGCACCTCACTTGGAT-1	LowQuality
TGCACCTCAGATCGGA-1	GoodQuality
TGCACCTCAGCGAACA-1	GoodQuality
TGCACCTGTACCGGCT-1	GoodQuality
TGCACCTGTGTGAATA-1	GoodQuality
TGCACCTGTTCGTCTC-1	GoodQuality
TGCACCTGTTGTGGAG-1	GoodQuality
TGCACCTTCGGAATCT-1	GoodQuality
TGCACCTTCTCTTGAT-1	LowQuality
TGCCAAAAGGAATTAC-1	GoodQuality
TGCCAAAAGTAATCCC-1	GoodQuality
TGCCAAAAGTGCGATG-1	LowQuality
TGCCAAAAGTGTACCT-1	GoodQuality
TGCCAAAAGTTTGCGT-1	GoodQuality
TGCCAAACACCATGTA-1	LowQuality
TGCCAAACATCAGTAC-1	GoodQuality
TGCCAAAGTTAAGTAG-1	GoodQuality
TGCCAAATCCCATTTA-1	LowQuality
TGCCAAATCTCCAGGG-1	LowQuality
TGCCAAATCTGCGGCA-1	GoodQuality
TGCCCATAGAACAATC-1	LowQuality
TGCCCATAGCCACGCT-1	GoodQuality
TGCCCATAGTCAATAG-1	GoodQuality
TGCCCATCACGGTTTA-1	LowQuality
TGCCCATGTCCAAGTT-1	LowQuality
TGCCCATGTTCACCTC-1	GoodQuality
TGCCCATGTTCCACAA-1	GoodQuality
TGCCCATGTTGTGGAG-1	GoodQuality
TGCCCATGTTTGGGCC-1	LowQuality
TGCCCATTCACCAGGC-1	GoodQuality
TGCCCATTCACCCGAG-1	LowQuality
TGCCCATTCGTTGCCT-1	LowQuality
TGCCCTAGTAAACGCG-1	GoodQuality
TGCCCTAGTAACGACG-1	GoodQuality
TGCCCTAGTCAACTGT-1	GoodQuality
TGCCCTAGTCGAGTTT-1	GoodQuality
TGCCCTAGTGACGGTA-1	GoodQuality
TGCCCTATCCTGTAGA-1	GoodQuality
TGCCCTATCGAATGCT-1	LowQuality
TGCCCTATCGTGTAGT-1	GoodQuality
TGCCCTATCTGCTGCT-1	GoodQuality
TGCGCAGAGGTAAACT-1	GoodQuality
TGCGCAGCAGACAGGT-1	GoodQuality
TGCGCAGCAGTTCATG-1	LowQuality
TGCGCAGGTATCACCA-1	GoodQuality
TGCGCAGGTGTCAATC-1	GoodQuality
TGCGCAGTCACTTACT-1	GoodQuality
TGCGCAGTCGCACTCT-1	GoodQuality
TGCGCAGTCTTTAGTC-1	GoodQuality
TGCGGGTAGATCTGCT-1	LowQuality
TGCGGGTGTAGAGGAA-1	LowQuality
TGCGGGTGTGCCTTGG-1	LowQuality
TGCGGGTGTTCACCTC-1	GoodQuality
TGCGGGTGTTTAAGCC-1	GoodQuality
TGCGGGTTCAGCCTAA-1	GoodQuality
TGCGTGGAGCTTATCG-1	LowQuality
TGCGTGGAGGGTGTTG-1	GoodQuality
TGCGTGGAGTGTCCCG-1	GoodQuality
TGCGTGGCACCAGCAC-1	GoodQuality
TGCGTGGCACGGTGTC-1	GoodQuality
TGCGTGGCACGTAAGG-1	GoodQuality
TGCGTGGGTAAGGGCT-1	LowQuality
TGCGTGGTCAGCATGT-1	GoodQuality
TGCGTGGTCTACCAGA-1	GoodQuality
TGCGTGGTCTATCGCC-1	GoodQuality
TGCTACCAGCCTATGT-1	LowQuality
TGCTACCAGCGCCTCA-1	GoodQuality
TGCTACCCAGTCAGAG-1	GoodQuality
TGCTACCGTAAATACG-1	GoodQuality
TGCTACCGTCAGATAA-1	GoodQuality
TGCTACCGTCTAGGTT-1	LowQuality
TGCTACCGTGTCAATC-1	GoodQuality
TGCTACCTCCAAAGTC-1	GoodQuality
TGCTACCTCCTTGGTC-1	GoodQuality
TGCTACCTCTGGCGTG-1	GoodQuality
TGCTACCTCTGTTGAG-1	GoodQuality
TGCTGCTAGTGAATTG-1	LowQuality
TGCTGCTCACAACGCC-1	GoodQuality
TGCTGCTCACCAGGCT-1	GoodQuality
TGCTGCTGTCATTAGC-1	GoodQuality
TGCTGCTGTGTTCGAT-1	LowQuality
TGCTGCTGTTCCTCCA-1	GoodQuality
TGCTGCTGTTCGTCTC-1	GoodQuality
TGCTGCTTCGGTGTCG-1	GoodQuality
TGGACGCAGAGATGAG-1	LowQuality
TGGACGCCACACCGAC-1	GoodQuality
TGGACGCCACCGGAAA-1	GoodQuality
TGGACGCGTAAGCACG-1	GoodQuality
TGGACGCGTAAGTTCC-1	GoodQuality
TGGACGCGTGTGCCTG-1	LowQuality
TGGACGCTCGCTTGTC-1	GoodQuality
TGGACGCTCTCTAGGA-1	GoodQuality
TGGCCAGAGCGTTGCC-1	GoodQuality
TGGCCAGAGCTGATAA-1	GoodQuality
TGGCCAGAGGAGTCTG-1	GoodQuality
TGGCCAGAGTGTCTCA-1	GoodQuality
TGGCCAGAGTTGAGAT-1	LowQuality
TGGCCAGCACAGGCCT-1	LowQuality
TGGCCAGCATGGAATA-1	GoodQuality
TGGCCAGGTCCAACTA-1	GoodQuality
TGGCCAGGTTTACTCT-1	GoodQuality
TGGCCAGTCAACGGCC-1	GoodQuality
TGGCCAGTCCCTCTTT-1	GoodQuality
TGGCCAGTCGCGCCAA-1	GoodQuality
TGGCGCAAGCTGAAAT-1	GoodQuality
TGGCGCAAGGTCATCT-1	GoodQuality
TGGCGCACAATGTTGC-1	GoodQuality
TGGCGCACACAGACAG-1	GoodQuality
TGGCGCACAGGGCATA-1	GoodQuality
TGGCGCACATCCCATC-1	GoodQuality
TGGCGCACATTCTCAT-1	GoodQuality
TGGCGCAGTAGCTCCG-1	GoodQuality
TGGCGCATCCGGGTGT-1	LowQuality
TGGCGCATCTAACTCT-1	GoodQuality
TGGCTGGAGACCGGAT-1	GoodQuality
TGGCTGGAGATGGGTC-1	GoodQuality
TGGCTGGAGGTAGCTG-1	LowQuality
TGGCTGGAGTAGTGCG-1	GoodQuality
TGGCTGGCACGCATCG-1	GoodQuality
TGGCTGGCAGGAATCG-1	GoodQuality
TGGCTGGGTCTAGGTT-1	GoodQuality
TGGCTGGGTCTCTCTG-1	GoodQuality
TGGGAAGAGGAACTGC-1	GoodQuality
TGGGAAGCACATCCAA-1	GoodQuality
TGGGAAGCATTGGCGC-1	GoodQuality
TGGGAAGGTACCGTAT-1	GoodQuality
TGGGAAGGTAGATTAG-1	GoodQuality
TGGGAAGGTCAAAGCG-1	GoodQuality
TGGGAAGGTGGTACAG-1	GoodQuality
TGGGAAGTCATCTGTT-1	GoodQuality
TGGGAAGTCCAAGCCG-1	GoodQuality
TGGGAAGTCGATAGAA-1	LowQuality
TGGGCGTAGGCAGTCA-1	GoodQuality
TGGGCGTAGTGAAGAG-1	LowQuality
TGGGCGTAGTTAAGTG-1	GoodQuality
TGGGCGTCAATGGAGC-1	GoodQuality
TGGGCGTCAGCGATCC-1	GoodQuality
TGGGCGTGTAAACACA-1	GoodQuality
TGGGCGTGTACGCACC-1	GoodQuality
TGGTTAGAGACTACAA-1	LowQuality
TGGTTAGAGGAGTACC-1	LowQuality
TGGTTAGAGTCAATAG-1	GoodQuality
TGGTTAGCACGAGAGT-1	GoodQuality
TGGTTAGCACGGTGTC-1	GoodQuality
TGGTTAGCAGATCTGT-1	GoodQuality
TGGTTAGCAGCCACCA-1	LowQuality
TGGTTAGCAGCCTTGG-1	GoodQuality
TGGTTAGCATCACCCT-1	LowQuality
TGGTTAGGTAAATGAC-1	GoodQuality
TGGTTAGGTGACGGTA-1	GoodQuality
TGGTTAGGTTCCACTC-1	GoodQuality
TGGTTAGGTTCGCTAA-1	LowQuality
TGGTTAGTCAAGATCC-1	GoodQuality
TGGTTCCCAAAGAATC-1	LowQuality
TGGTTCCCAATGTTGC-1	GoodQuality
TGGTTCCCACATTTCT-1	GoodQuality
TGGTTCCCACGCCAGT-1	GoodQuality
TGGTTCCCATTCGACA-1	GoodQuality
TGGTTCCGTCTCATCC-1	LowQuality
TGGTTCCGTGCTTCTC-1	GoodQuality
TGGTTCCGTGTCTGAT-1	GoodQuality
TGGTTCCTCACGACTA-1	GoodQuality
TGGTTCCTCGGTCCGA-1	GoodQuality
TGTATTCCACACGCTG-1	GoodQuality
TGTATTCCACGAGGTA-1	GoodQuality
TGTATTCCAGACTCGC-1	GoodQuality
TGTATTCCATATACGC-1	GoodQuality
TGTATTCGTAAGGGCT-1	GoodQuality
TGTATTCGTCGCCATG-1	GoodQuality
TGTATTCTCACCTCGT-1	GoodQuality
TGTATTCTCCGTAGGC-1	GoodQuality
TGTATTCTCTGACCTC-1	GoodQuality
TGTCCCAAGCCAGGAT-1	GoodQuality
TGTCCCACAAGTCTAC-1	LowQuality
TGTCCCACAGACGCAA-1	GoodQuality
TGTCCCAGTAACGTTC-1	GoodQuality
TGTCCCAGTAGCAAAT-1	GoodQuality
TGTCCCAGTAGTGAAT-1	GoodQuality
TGTCCCAGTCATATGC-1	GoodQuality
TGTCCCAGTGAAATCA-1	GoodQuality
TGTCCCAGTTAAAGAC-1	GoodQuality
TGTCCCAGTTGTCGCG-1	GoodQuality
TGTCCCATCACCAGGC-1	GoodQuality
TGTGGTAAGTATTGGA-1	GoodQuality
TGTGGTACACACGCTG-1	GoodQuality
TGTGGTACACCATCCT-1	LowQuality
TGTGGTACACGTCAGC-1	GoodQuality
TGTGGTACAGGTGGAT-1	GoodQuality
TGTGGTACATCCGCGA-1	LowQuality
TGTGGTAGTCACAAGG-1	LowQuality
TGTGGTAGTCATGCCG-1	GoodQuality
TGTGGTAGTCTAAAGA-1	GoodQuality
TGTGGTAGTGTAAGTA-1	LowQuality
TGTGGTATCAATCTCT-1	GoodQuality
TGTGGTATCCAGTATG-1	LowQuality
TGTGGTATCCTTTACA-1	LowQuality
TGTGGTATCGCCGTGA-1	LowQuality
TGTGTTTAGAAAGTGG-1	GoodQuality
TGTGTTTAGAGGTAGA-1	LowQuality
TGTGTTTAGCGTCTAT-1	LowQuality
TGTGTTTAGCTGATAA-1	GoodQuality
TGTGTTTAGGATCGCA-1	GoodQuality
TGTGTTTAGTGGACGT-1	LowQuality
TGTGTTTGTAGAAGGA-1	LowQuality
TGTTCCGAGAGGGATA-1	LowQuality
TGTTCCGAGCCTCGTG-1	GoodQuality
TGTTCCGCAATAAGCA-1	GoodQuality
TGTTCCGCACTAGTAC-1	GoodQuality
TGTTCCGCAGGATCGA-1	GoodQuality
TGTTCCGGTATCACCA-1	GoodQuality
TGTTCCGGTCGAGATG-1	LowQuality
TGTTCCGGTCTTGATG-1	GoodQuality
TGTTCCGTCCGTAGGC-1	GoodQuality
TTAACTCAGACGCAAC-1	GoodQuality
TTAACTCAGCACACAG-1	LowQuality
TTAACTCAGCGATCCC-1	GoodQuality
TTAACTCAGTGTACTC-1	LowQuality
TTAACTCCATTTCACT-1	GoodQuality
TTAACTCTCACATAGC-1	LowQuality
TTAACTCTCAGTGTTG-1	LowQuality
TTAACTCTCGCCAGCA-1	GoodQuality
TTAGGACAGAATCTCC-1	GoodQuality
TTAGGACAGAGTAAGG-1	LowQuality
TTAGGACAGATCTGAA-1	GoodQuality
TTAGGACAGGGAACGG-1	GoodQuality
TTAGGACAGTCGTACT-1	GoodQuality
TTAGGACAGTGAAGAG-1	GoodQuality
TTAGGACCATGGGAAC-1	GoodQuality
TTAGGACCATTCCTGC-1	LowQuality
TTAGGACGTAGAGTGC-1	LowQuality
TTAGGACGTCCCGACA-1	LowQuality
TTAGGACGTCGACTGC-1	GoodQuality
TTAGGACGTCGATTGT-1	LowQuality
TTAGGACTCTTAGCCC-1	GoodQuality
TTAGGCAAGACCTTTG-1	GoodQuality
TTAGGCACATCCCACT-1	LowQuality
TTAGGCACATGCGCAC-1	GoodQuality
TTAGGCAGTAAGTAGT-1	LowQuality
TTAGGCAGTACGCACC-1	LowQuality
TTAGGCAGTCGACTAT-1	LowQuality
TTAGGCAGTCTCGTTC-1	GoodQuality
TTAGGCATCAGGCCCA-1	GoodQuality
TTAGGCATCTGAGTGT-1	GoodQuality
TTAGGCATCTTAGCCC-1	GoodQuality
TTAGTTCAGAGGACGG-1	GoodQuality
TTAGTTCAGAGTCTGG-1	GoodQuality
TTAGTTCCAAAGCGGT-1	GoodQuality
TTAGTTCGTCTGCAAT-1	GoodQuality
TTAGTTCGTTCACCTC-1	LowQuality
TTAGTTCTCATAAAGG-1	LowQuality
TTAGTTCTCCAGAGGA-1	LowQuality
TTAGTTCTCCGCGTTT-1	GoodQuality
TTAGTTCTCGCCATAA-1	GoodQuality
TTAGTTCTCGGCGGTT-1	LowQuality
TTAGTTCTCTGTTTGT-1	GoodQuality
TTATGCTAGAGTAAGG-1	GoodQuality
TTATGCTCAAAGGTGC-1	GoodQuality
TTATGCTCAATGTTGC-1	GoodQuality
TTATGCTCACCATGTA-1	GoodQuality
TTATGCTCATAGTAAG-1	LowQuality
TTATGCTGTACAGTGG-1	GoodQuality
TTATGCTGTACTCGCG-1	GoodQuality
TTATGCTGTATTCGTG-1	GoodQuality
TTATGCTGTCTTCTCG-1	GoodQuality
TTATGCTGTGCGCTTG-1	LowQuality
TTATGCTTCAGGCGAA-1	LowQuality
TTATGCTTCTCTAGGA-1	GoodQuality
TTATGCTTCTGGGCCA-1	LowQuality
TTATGCTTCTTTACGT-1	GoodQuality
TTCCCAGAGCGCTCCA-1	GoodQuality
TTCCCAGAGGCATTGG-1	GoodQuality
TTCCCAGCAGCGTCCA-1	GoodQuality
TTCCCAGCAGTTCCCT-1	LowQuality
TTCCCAGTCATGTGGT-1	GoodQuality
TTCCCAGTCCCGGATG-1	GoodQuality
TTCCCAGTCCGATATG-1	GoodQuality
TTCCCAGTCTCGCATC-1	LowQuality
TTCGAAGAGATCACGG-1	GoodQuality
TTCGAAGAGCCCAATT-1	GoodQuality
TTCGAAGAGGTACTCT-1	LowQuality
TTCGAAGAGTCCGGTC-1	GoodQuality
TTCGAAGGTAGAGCTG-1	GoodQuality
TTCGAAGGTCGCCATG-1	LowQuality
TTCGAAGTCAGCATGT-1	GoodQuality
TTCGGTCAGCAATATG-1	GoodQuality
TTCGGTCAGTGCAAGC-1	GoodQuality
TTCGGTCCAAATACAG-1	GoodQuality
TTCGGTCCACCATGTA-1	GoodQuality
TTCGGTCCAGGCTGAA-1	GoodQuality
TTCGGTCGTAGCCTAT-1	GoodQuality
TTCGGTCGTCACCTAA-1	LowQuality
TTCGGTCTCCTATTCA-1	GoodQuality
TTCGGTCTCGCCAGCA-1	GoodQuality
TTCGGTCTCTCTGCTG-1	LowQuality
TTCTACAAGAAACGCC-1	LowQuality
TTCTACAAGCCTCGTG-1	LowQuality
TTCTACAAGCGATTCT-1	GoodQuality
TTCTACAAGTAGGCCA-1	LowQuality
TTCTACACAGACGTAG-1	LowQuality
TTCTACAGTCTCTTAT-1	GoodQuality
TTCTACATCCTGCTTG-1	GoodQuality
TTCTACATCGTGGACC-1	GoodQuality
TTCTCAAAGAGACTAT-1	LowQuality
TTCTCAAAGCCAACAG-1	GoodQuality
TTCTCAAAGGACAGCT-1	LowQuality
TTCTCAACAAACGTGG-1	GoodQuality
TTCTCAACATCTCGCT-1	LowQuality
TTCTCAACATGCCTAA-1	LowQuality
TTCTCAAGTAGGCATG-1	LowQuality
TTCTCAAGTCATATGC-1	GoodQuality
TTCTCAAGTGTATGGG-1	GoodQuality
TTCTCAAGTTACGGAG-1	LowQuality
TTCTCAATCGGTCCGA-1	GoodQuality
TTCTCAATCTGGGCCA-1	GoodQuality
TTCTCAATCTTTAGTC-1	LowQuality
TTCTCCTAGCGGCTTC-1	LowQuality
TTCTCCTAGCTGTTCA-1	GoodQuality
TTCTCCTAGGACACCA-1	GoodQuality
TTCTCCTAGGATGTAT-1	GoodQuality
TTCTCCTAGGCACATG-1	GoodQuality
TTCTCCTAGTCTCAAC-1	LowQuality
TTCTCCTCACTCTGTC-1	GoodQuality
TTCTCCTCAGATCGGA-1	GoodQuality
TTCTCCTCAGGAACGT-1	GoodQuality
TTCTCCTGTACCATCA-1	LowQuality
TTCTCCTGTCACACGC-1	GoodQuality
TTCTCCTGTCATGCCG-1	GoodQuality
TTCTCCTGTGCAGGTA-1	LowQuality
TTCTCCTGTTTAGCTG-1	GoodQuality
TTCTCCTTCGGAATCT-1	GoodQuality
TTCTCCTTCTTGCCGT-1	GoodQuality
TTCTTAGAGAAGATTC-1	LowQuality
TTCTTAGAGACAAAGG-1	GoodQuality
TTCTTAGCACACCGCA-1	GoodQuality
TTCTTAGCACGGCCAT-1	LowQuality
TTCTTAGCACTATCTT-1	LowQuality
TTCTTAGGTTCAGACT-1	GoodQuality
TTCTTAGTCGCCGTGA-1	GoodQuality
TTCTTAGTCGGAAACG-1	LowQuality
TTCTTAGTCGTCCGTT-1	GoodQuality
TTGAACGAGTCAATAG-1	GoodQuality
TTGAACGAGTTACGGG-1	LowQuality
TTGAACGGTAGTAGTA-1	LowQuality
TTGAACGGTTCGTGAT-1	GoodQuality
TTGAACGTCAGTTGAC-1	GoodQuality
TTGACTTAGAGTCGGT-1	GoodQuality
TTGACTTAGTGATCGG-1	LowQuality
TTGACTTCAAAGCAAT-1	GoodQuality
TTGACTTTCCACTCCA-1	GoodQuality
TTGACTTTCGTTGCCT-1	LowQuality
TTGCCGTAGAGACGAA-1	LowQuality
TTGCCGTAGCCAGGAT-1	GoodQuality
TTGCCGTAGGTGATTA-1	LowQuality
TTGCCGTCAAGCCATT-1	GoodQuality
TTGCCGTCAGCTCGAC-1	GoodQuality
TTGCCGTGTATAATGG-1	LowQuality
TTGCCGTGTTCCATGA-1	GoodQuality
TTGCCGTTCTCCCTGA-1	LowQuality
TTGCGTCAGCAGACTG-1	LowQuality
TTGCGTCAGCGTAATA-1	GoodQuality
TTGCGTCAGCGTGAAC-1	GoodQuality
TTGCGTCAGCTAACAA-1	GoodQuality
TTGCGTCAGCTTCGCG-1	GoodQuality
TTGCGTCCAATGAAAC-1	GoodQuality
TTGCGTCCACAGAGGT-1	GoodQuality
TTGCGTCCATTTCACT-1	GoodQuality
TTGCGTCGTACTTCTT-1	GoodQuality
TTGCGTCGTATCAGTC-1	GoodQuality
TTGCGTCGTCGGCACT-1	LowQuality
TTGCGTCTCTACTTAC-1	LowQuality
TTGGAACAGGCAGTCA-1	GoodQuality
TTGGAACCAAGAAAGG-1	GoodQuality
TTGGAACCACAACTGT-1	GoodQuality
TTGGAACCACCCATTC-1	GoodQuality
TTGGAACGTAGTGAAT-1	GoodQuality
TTGGAACGTTTGGGCC-1	GoodQuality
TTGGAACTCGATGAGG-1	GoodQuality
TTGGAACTCGGTTAAC-1	GoodQuality
TTGGCAAAGATCCGAG-1	GoodQuality
TTGGCAACAAGCGTAG-1	GoodQuality
TTGGCAACAGATCTGT-1	LowQuality
TTGGCAACAGATGGCA-1	LowQuality
TTGGCAACAGCTCGAC-1	GoodQuality
TTGGCAAGTCAATACC-1	GoodQuality
TTGGCAAGTGGACGAT-1	LowQuality
TTGGCAAGTTTGACTG-1	LowQuality
TTGGCAATCATCGATG-1	GoodQuality
TTGGCAATCCAGTATG-1	GoodQuality
TTGTAGGAGCAATATG-1	GoodQuality
TTGTAGGAGGGTATCG-1	GoodQuality
TTGTAGGAGGTGATAT-1	LowQuality
TTGTAGGCAAAGTCAA-1	GoodQuality
TTGTAGGCAGCATACT-1	LowQuality
TTGTAGGGTAGCTCCG-1	GoodQuality
TTGTAGGGTCGCTTCT-1	GoodQuality
TTGTAGGGTCTCAACA-1	LowQuality
TTGTAGGGTTCAGACT-1	GoodQuality
TTGTAGGTCCTAGTGA-1	GoodQuality
TTTACTGAGAAACGCC-1	GoodQuality
TTTACTGAGCTGCAAG-1	GoodQuality
TTTACTGAGGCAAAGA-1	GoodQuality
TTTACTGAGTTTCCTT-1	GoodQuality
TTTACTGCAAGCCCAC-1	GoodQuality
TTTACTGCACACCGAC-1	GoodQuality
TTTACTGCACAGGCCT-1	GoodQuality
TTTACTGCACCAGATT-1	GoodQuality
TTTACTGCATTCACTT-1	GoodQuality
TTTACTGGTAGCGCAA-1	LowQuality
TTTACTGGTAGGAGTC-1	GoodQuality
TTTACTGGTAGGGACT-1	GoodQuality
TTTACTGGTATCTGCA-1	GoodQuality
TTTACTGGTCGCGTGT-1	LowQuality
TTTACTGTCAACACTG-1	GoodQuality
TTTACTGTCTTCGAGA-1	LowQuality
TTTATGCAGAAGGCCT-1	GoodQuality
TTTATGCAGCCGGTAA-1	GoodQuality
TTTATGCAGGCGACAT-1	LowQuality
TTTATGCCAGATTGCT-1	GoodQuality
TTTATGCCATGCCTAA-1	GoodQuality
TTTATGCCATTGCGGC-1	LowQuality
TTTATGCGTACATGTC-1	GoodQuality
TTTATGCGTAGAGGAA-1	GoodQuality
TTTATGCGTCCCGACA-1	LowQuality
TTTATGCGTCCGTGAC-1	GoodQuality
TTTATGCGTTGTACAC-1	GoodQuality
TTTATGCTCCTGTAGA-1	GoodQuality
TTTATGCTCTTTACGT-1	GoodQuality
TTTCCTCAGACAATAC-1	LowQuality
TTTCCTCAGCGATCCC-1	LowQuality
TTTCCTCCAGGCTGAA-1	LowQuality
TTTCCTCGTCCGTGAC-1	LowQuality
TTTCCTCTCAACCAAC-1	LowQuality
TTTCCTCTCAGTCCCT-1	GoodQuality
TTTCCTCTCCGTCATC-1	GoodQuality
TTTGCGCAGTTCCACA-1	LowQuality
TTTGCGCGTCTTGCGG-1	LowQuality
TTTGCGCGTGACCAAG-1	LowQuality
TTTGCGCTCCCAAGTA-1	LowQuality
TTTGCGCTCGTTGACA-1	GoodQuality
TTTGGTTAGATGTTAG-1	GoodQuality
TTTGGTTAGGATGGTC-1	LowQuality
TTTGGTTCAACCGCCA-1	LowQuality
TTTGGTTCAACTGCTA-1	GoodQuality
TTTGGTTCAAGACGTG-1	LowQuality
TTTGGTTCACCGCTAG-1	GoodQuality
TTTGGTTGTAAATACG-1	LowQuality
TTTGGTTGTTGCCTCT-1	GoodQuality
TTTGGTTTCTGGTATG-1	LowQuality
TTTGGTTTCTTGGGTA-1	LowQuality
TTTGTCAAGAGCCCAA-1	GoodQuality
TTTGTCAAGATATGCA-1	GoodQuality
TTTGTCAAGTTACGGG-1	LowQuality
TTTGTCACAAGTTGTC-1	GoodQuality
TTTGTCACACAGGCCT-1	GoodQuality
TTTGTCACAGGCTCAC-1	GoodQuality
TTTGTCACATGAGCGA-1	GoodQuality
TTTGTCACATGGTCTA-1	LowQuality
TTTGTCAGTATCACCA-1	LowQuality
TTTGTCAGTCAACATC-1	GoodQuality
TTTGTCAGTGCAACGA-1	GoodQuality
TTTGTCAGTTCACGGC-1	LowQuality
TTTGTCAGTTCCGGCA-1	GoodQuality
TTTGTCATCAGCTGGC-1	LowQuality
TTTGTCATCGCAGGCT-1	LowQuality
TTTGTCATCTGTACGA-1	LowQuality
